30 100
CTAGAAAGGGGCCCGCACTGTTCAGAAAGG|GATGCCTCTGACCTCCGCTAGAAAGGGGCC
AATGTCGACAGTACAACCGACTTCGGCCCC|ATTTCGCTGGGGTCTAAGGCGATGTGTTCA
GACTACATTAAGATTGCCACACCTCCGCTA|ACGTGGGGCTTTCCCCGTTGGGCATAGATC
TTGTAGCTCCTAGCTTCCCACCAGGCGCCG|AGGCTGACCTCCGCTACCTCCGCTAGAAAG
AGTATGCCGTTTCTGTAGAGATGCCGAGGA|ACTTACGTAGTGAGTCTTCCGTGTAGAACA
CTCCGCTAGAAAGGGGCCCGCACTGTTCTA|TGACCGGAAGCCTCGGACCTCCGCTAGAAA
GTGCTACATTCGTCGTACGCATACTGCTCG|AGCGCGCAACGAGTATGCCGTTTCTGTAGA
CGTAGCGTTCGTCAGGTGGAGAGCCAATGC|TGCCCCCTATTTCTACCGTACGGTACGCTT
TTCGCATGTTTACTAGGGACGTGGGGCTTT|CTGGGTGATAGCCCGTCCAGTCGTAACGGT
GCATGCATATAGCAAACCCTGGGTGATAGC|AATGTCGACAGTACAACCGACTTCGGCCCC
ATACAAGTTGAGGGTACACGTATCTGGTGT|ATACTGCTCGTCGGGCTTACCTCGTTCCCG
GGCCCGCACTGTTCTAGGATAAGGAATTCC|GGACCTCCGCTAGAAAGGGGCCCGCACTGT
GCCCGCACTGTTCGTCGTGCTACATTCGTC|CGTATGCGGATGGCGAAGCGCGCAACGAGT
AACCTCCGCTAGAAAGGGGCCCGCACTGTT|GATTGACCGGAAGCCTCGGACCTCCGCTAG
CTCCGCTAGAAAGGGGCCCGCACTGTTCTA|TAAATGCATTCACGTGGTTTAAATCCCGGC
GTTCGTCGTGCTACATTCGTCGTACGCATA|ATGGCGAAGCGCGCAACGAGTATGCCGTTT
GTTGCCTGGTATAACTTACGGGCCTCGTGT|CACTGTTCGTCGTGCTACATTCGTCGTACG
GGCCCGCACTGTTCCCACCTCCGCACCTCC|GCTTAACGATAGCTGCCGGAGAAGTTTAAA
GTGGGGCTTTCCCCGTTGGGCATAGATCTA|TCGTAACGGTCACTATAGCAAACCTCCGCT
GCACTGTTCGCGCTGCACCTCCGCTAGAAA|TAGCTGATCACGTGACCCACCTGCTGCATG
GCATCAGGCGCGGAACGTTCGACGGACTAC|GCACTGTTCGCATGTTTACTAGGGACGTGG
TCGTAGCGTTCGTCAGGTGGAGAGCCAATG|ATGCCCCCTATTTCTACCGTACGGTACGCT
TAAATGCATTCACGTGGTTTAAATCCCGGC|GGCCCGCACTGTTCGCGCTGCACCTCCGCT
GTTGGGCATAGATCTACTGGCTGAGTTTCC|ATAGCAAACCTCCGCTAGAAAGGGGCCCGC
AAAACAAGTTCGTCCCAACCTGGAGATTAG|AACACTCGTAGCGTTCGTCAGGTGGAGAGC
GTCCAGTCGTAACGGTCACTATAGCAAACC|CTCCCGTGAGGATGGACACAAAACGAGATT
TTGCCTGGTATAACTTACGGGCCTCGTGTA|ACTGTTCGTCGTGCTACATTCGTCGTACGC
ACTGTTCGGTGCGAACTTACGTAGTGAGTC|CCGCTAGAAAGGGGCCCGCACTGTTCACTG
CCTCCGCTAGAAAGGGGCCCGCACTGTTCT|TTAAATGCATTCACGTGGTTTAAATCCCGG
ACACTCGTAGCGTTCGTCAGGTGGAGAGCC|GCCCATGCCCCCTATTTCTACCGTACGGTA
ACAAGTTGAGGGTACACGTATCTGGTGTTC|ACTGCTCGTCGGGCTTACCTCGTTCCCGGC
AAGGGGCCCGCACTGTTCAAGGGGCCCGCA|ATCAGGCGCGGAACGTTCGACGGACTACAT
CATGCTACAACACCTCCGCTAGAAAGGGGC|TTCAGTTAATCTCGGGGTAGCCCATGTGCT
ACCCACCTGCTGCATGCATATAGCAAACCC|AGTCCGGGGAAAATGTCGACAGTACAACCG
AATGCGACCACGTCGCGTTGATGCCTCTGA|CGCTTACATCCAATGATTTCAGGTAACGAA
GCTGAGTTTCCTGGCGACGAGTCCTTGTCC|AAGGGGCCCGCACTGTTCTAGGATAAGGAA
CGTGTAGAACAACACTCGTAGCGTTCGTCA|ATCGCTAACGAGCCCATGCCCCCTATTTCT
CCCATCTCCCGTGAGGATGGACACAAAACG|TCAGGCCCCGGCTCGGGGGCGCTGTGGGAA
CATAGATCTACTGGCTGAGTTTCCTGGCGA|AACCTCCGCTAGAAAGGGGCCCGCACTGTT
TCTACCGTACGGTACGCTTACATCCAATGA|CCTCCGCTAGAAAGGGGCCCGCACTGTTCA
TCCCTCCGCTAGAAAGGGGCCCGCACTGTT|CGAAAGTATTTCGTTATACGTATGCGGATG
ACGAGCCCATGCCCCCTATTTCTACCGTAC|GGGCCCGCACTGTTCTAGAACCTCCGCTAG
TTCTAGAACCTCCGCTAGAAAGGGGCCCGC|CCGGCGCCTGACGTTACGCATCAGGCGCGG
GGGGCCCGCACTGTTCTAGAACCTCCGCTA|CGTGGTTTAAATCCCGGCGCCTGACGTTAC
GGGGCCCGCACTGTTCCTCCGCTAGAAAGG|GGCTGAGTTTCCTGGCGACGAGTCCTTGTC
GTCCCAACCTGGAGATTAGGCTGACCTCCG|CGTTCGTCAGGTGGAGAGCCAATGCGACCA
AGCCCGTCCAGTCGTAACGGTCACTATAGC|CCCATCTCCCGTGAGGATGGACACAAAACG
ACTTCGGCCCCATCTCCCGTGAGGATGGAC|CGATGTGTTCAGGCCCCGGCTCGGGGGCGC
GAACATGCTACAACACCTCCGCTAGAAAGG|CTGTTCAGTTAATCTCGGGGTAGCCCATGT
GTGGAGAGCCAATGCGACCACGTCGCGTTG|CCGTACGGTACGCTTACATCCAATGATTTC
GAGGAAAACAAGTTCGTCCCAACCTGGAGA|GAACAACACTCGTAGCGTTCGTCAGGTGGA
AAAGGGGCCCGCACCTCCGCTAGAAAGGGG|CACCTCCGCTAGAAAGGGGCCCGCACTGTT
ACTACATTAAGATTGCCACACCTCCGCTAG|CGTGGGGCTTTCCCCGTTGGGCATAGATCT
CTATTTCTACCGTACGGTACGCTTACATCC|TAGAACCTCCGCTAGAAAGGGGCCCGCACT
ACCTCCGCTAGAAAGGGGCCCGCACTGTTC|CTGACGTTACGCATCAGGCGCGGAACGTTC
TGAGGGTACACGTATCTGGTGTTCCGCGTA|CGTCGGGCTTACCTCGTTCCCGGCTAGCGT
CCCATGCCCCCTATTTCTACCGTACGGTAC|CGCACTGTTCTAGAACCTCCGCTAGAAAGG
CAACACTCGTAGCGTTCGTCAGGTGGAGAG|GAGCCCATGCCCCCTATTTCTACCGTACGG
CGCGGAACGTTCGACGGACTACATTAAGAT|CGCATGTTTACTAGGGACGTGGGGCTTTCC
GGCGCCGAAAGTATTTCGTTATACGTATGC|TAGAAAGGGGCCCGCACTGTTCAGAAAGGG
TTCGTCCCAACCTGGAGATTAGGCTGACCT|TAGCGTTCGTCAGGTGGAGAGCCAATGCGA
AAAGGGGCCCGCACTGTTCAAGGGGCCCGC|CATCAGGCGCGGAACGTTCGACGGACTACA
GCGCGCAACGAGTATGCCGTTTCTGTAGAG|TTCGGTGCGAACTTACGTAGTGAGTCTTCC
TTGTCCTTATTAGCTGATCACGTGACCCAC|AAGGAATTCCACAAAGATCCTTCCAGTCCG
CGCCTGACGTTACGCATCAGGCGCGGAACG|TAGAAAGGGGCCCGCACTGTTCGCATGTTT
ATCAGGCGCGGAACGTTCGACGGACTACAT|ACTGTTCGCATGTTTACTAGGGACGTGGGG
AGATAGTTGCCTGGTATAACTTACGGGCCT|GCCCGCACTGTTCGTCGTGCTACATTCGTC
TCCCACCAGGCGCCGAAAGTATTTCGTTAT|ACCTCCGCTAGAAAGGGGCCCGCACTGTTC
CATTAAGATTGCCACACCTCCGCTAGAAAG|GGGCTTTCCCCGTTGGGCATAGATCTACTG
CAACCTGGAGATTAGGCTGACCTCCGCTAC|CGTCAGGTGGAGAGCCAATGCGACCACGTC
AAGGGGCCCGCACTGTTCCTCCGCTAGAAA|CTGGCTGAGTTTCCTGGCGACGAGTCCTTG
AGGGGCCCGCACTGTTCGGTGCGAACTTAC|GCCCGCACCTCCGCTAGAAAGGGGCCCGCA
GTTCAGTTAATCTCGGGGTAGCCCATGTGC|AGATTGCCACACCTCCGCTAGAAAGGGGCC
AACAAGTTCGTCCCAACCTGGAGATTAGGC|CACTCGTAGCGTTCGTCAGGTGGAGAGCCA
CGTTCGACGGACTACATTAAGATTGCCACA|TTACTAGGGACGTGGGGCTTTCCCCGTTGG
GGGGCCCGCACTGTTCCCTCCGCTAGAAAG|TTCCCACCAGGCGCCGAAAGTATTTCGTTA
CCTCCGCTAGAAAGGGGCCCGCACTGTTCA|CGCGTTGATGCCTCTGACCTCCGCTAGAAA
TTCAGTTAATCTCGGGGTAGCCCATGTGCT|GATTGCCACACCTCCGCTAGAAAGGGGCCC
CCGCACTGTTCCTCCGCTAGAAAGGGGCCC|AGTTTCCTGGCGACGAGTCCTTGTCCTTAT
TAGAAAGGGGCCCGCACTGTTCAGAAAGGG|ATGCCTCTGACCTCCGCTAGAAAGGGGCCC
ATCCAATGATTTCAGGTAACGAACATGCTA|CACTGTTCAAGGGGCCCGCACTGTTCAGTT
GCAAACCCTGGGTGATAGCCCGTCCAGTCG|TACAACCGACTTCGGCCCCATCTCCCGTGA
GGCCCCATCTCCCGTGAGGATGGACACAAA|TGTTCAGGCCCCGGCTCGGGGGCGCTGTGG
TTCCAGTCCGGGGAAAATGTCGACAGTACA|GCAGGTCAACTTCATATTTCGCTGGGGTCT
GCTGACCTCCGCTACCTCCGCTAGAAAGGG|CAATGCGACCACGTCGCGTTGATGCCTCTG
CCCCTATTTCTACCGTACGGTACGCTTACA|TTCTAGAACCTCCGCTAGAAAGGGGCCCGC
AGGTGGAGAGCCAATGCGACCACGTCGCGT|TACCGTACGGTACGCTTACATCCAATGATT
TTTCCCCGTTGGGCATAGATCTACTGGCTG|GGTCACTATAGCAAACCTCCGCTAGAAAGG
CCGAAAGTATTTCGTTATACGTATGCGGAT|AAGGGGCCCGCACTGTTCAGAAAGGGGCCC
CATCGCTAACGAGCCCATGCCCCCTATTTC|CTAGAAAGGGGCCCGCACTGTTCTAGAACC
GCGCAACGAGTATGCCGTTTCTGTAGAGAT|CGGTGCGAACTTACGTAGTGAGTCTTCCGT
CAAAGATCCTTCCAGTCCGGGGAAAATGTC|CTTCGCTCCGCAGGTCAACTTCATATTTCG
TACCTCGTTCCCGGCTAGCGTGGTTGGTAG|AGGAAAACAAGTTCGTCCCAACCTGGAGAT
GCCTCTTCGAACCTCCGCTAGAAAGGGGCC|GGTTGGTAGCTTGTAGCTCCTAGCTTCCCA
CACGTCGCGTTGATGCCTCTGACCTCCGCT|TCCAATGATTTCAGGTAACGAACATGCTAC
CGCACTGTTCCTCCGCTAGAAAGGGGCCCG|GTTTCCTGGCGACGAGTCCTTGTCCTTATT
GCCCATGTGCTTAACGATAGCTGCCGGAGA|GAAAGGGGCCCGCACTGTTCCTCCGCTAGA
TTACGCATCAGGCGCGGAACGTTCGACGGA|GCCCGCACTGTTCGCATGTTTACTAGGGAC
GTCGTAACGGTCACTATAGCAAACCTCCGC|GTGAGGATGGACACAAAACGAGATTGACCG
TACATTAAGATTGCCACACCTCCGCTAGAA|TGGGGCTTTCCCCGTTGGGCATAGATCTAC
ATAGTTGCCTGGTATAACTTACGGGCCTCG|CCGCACTGTTCGTCGTGCTACATTCGTCGT
CGAGTATGCCGTTTCTGTAGAGATGCCGAG|GAACTTACGTAGTGAGTCTTCCGTGTAGAA
CCTGCTGCATGCATATAGCAAACCCTGGGT|GGGGAAAATGTCGACAGTACAACCGACTTC
AACTTACGGGCCTCGTGTAATACAAGTTGA|TGCTACATTCGTCGTACGCATACTGCTCGT
AGTTTCCTGGCGACGAGTCCTTGTCCTTAT|GGCCCGCACTGTTCTAGGATAAGGAATTCC
AGAAAGGGGCCCGCACTGTTCTAGGATAAG|AAGCCTCGGACCTCCGCTAGAAAGGGGCCC
ACAACACCTCCGCTAGAAAGGGGCCCGCAC|TAATCTCGGGGTAGCCCATGTGCTTAACGA
TCCGCTAGAAAGGGGCCCGCACTGTTCCCA|GGGTAGCCCATGTGCTTAACGATAGCTGCC
CCGCGTAGCCTCTTCGAACCTCCGCTAGAA|CTAGCGTGGTTGGTAGCTTGTAGCTCCTAG
ACCTCGTTCCCGGCTAGCGTGGTTGGTAGC|GGAAAACAAGTTCGTCCCAACCTGGAGATT
TCCGCACCTCCGCTAGAAAGGGGCCCGCAC|AGAAGTTTAAATGCATTCACGTGGTTTAAA
TAACTTACGGGCCTCGTGTAATACAAGTTG|GTGCTACATTCGTCGTACGCATACTGCTCG
CTCCGCTAGAAAGGGGCCCGCACCTCCGCT|ATGCTACAACACCTCCGCTAGAAAGGGGCC
AAAGATCCTTCCAGTCCGGGGAAAATGTCG|TTCGCTCCGCAGGTCAACTTCATATTTCGC
ATCTGGTGTTCCGCGTAGCCTCTTCGAACC|TCGTTCCCGGCTAGCGTGGTTGGTAGCTTG
TTCCCACCTCCGCACCTCCGCTAGAAAGGG|GCTGCCGGAGAAGTTTAAATGCATTCACGT
GATGGACACAAAACGAGATTGACCGGAAGC|GGGGCGCTGTGGGAATGATCATAGTAGGCT
GGCCCGCACTGTTCCTCCGCTAGAAAGGGG|CTGAGTTTCCTGGCGACGAGTCCTTGTCCT
AGGGGCCCGCACTGTTCTAGAACCTCCGCT|ACGTGGTTTAAATCCCGGCGCCTGACGTTA
CAGGTAACGAACATGCTACAACACCTCCGC|GGCCCGCACTGTTCAGTTAATCTCGGGGTA
CAAACCTCCGCTAGAAAGGGGCCCGCACTG|GAGATTGACCGGAAGCCTCGGACCTCCGCT
TCCCGGCTAGCGTGGTTGGTAGCTTGTAGC|AAGTTCGTCCCAACCTGGAGATTAGGCTGA
CACTGTTCAAGGGGCCCGCACTGTTCAGTT|GAACGTTCGACGGACTACATTAAGATTGCC
GCATATAGCAAACCCTGGGTGATAGCCCGT|TCGACAGTACAACCGACTTCGGCCCCATCT
TAGAAAGGGGCCCGCACTGTTCCTCCGCTA|TCTACTGGCTGAGTTTCCTGGCGACGAGTC
CTTACCTCGTTCCCGGCTAGCGTGGTTGGT|CGAGGAAAACAAGTTCGTCCCAACCTGGAG
GAACCTCCGCTAGAAAGGGGCCCGCACTGT|GCTTGTAGCTCCTAGCTTCCCACCAGGCGC
TAACGGTCACTATAGCAAACCTCCGCTAGA|GGATGGACACAAAACGAGATTGACCGGAAG
AAAGGGGCCCGCACTGTTCCCTCCGCTAGA|AGCTTCCCACCAGGCGCCGAAAGTATTTCG
ATGTCGACAGTACAACCGACTTCGGCCCCA|TTTCGCTGGGGTCTAAGGCGATGTGTTCAG
CGCGCAACGAGTATGCCGTTTCTGTAGAGA|TCGGTGCGAACTTACGTAGTGAGTCTTCCG
CCTCTTCGAACCTCCGCTAGAAAGGGGCCC|GTTGGTAGCTTGTAGCTCCTAGCTTCCCAC
TTGGGCATAGATCTACTGGCTGAGTTTCCT|TAGCAAACCTCCGCTAGAAAGGGGCCCGCA
GTATAACTTACGGGCCTCGTGTAATACAAG|GTCGTGCTACATTCGTCGTACGCATACTGC
GGGCCCGCACTGTTCACTGTTCATCGCTAA|GTTCCCACCTCCGCACCTCCGCTAGAAAGG
AACATGCTACAACACCTCCGCTAGAAAGGG|TGTTCAGTTAATCTCGGGGTAGCCCATGTG
TCGTACGCATACTGCTCGTCGGGCTTACCT|GTATGCCGTTTCTGTAGAGATGCCGAGGAA
CTGTTCAGAAAGGGGCCCGCACTGTTCGGT|CTAGAAAGGGGCCCGCACCTCCGCTAGAAA
GGGTAGCCCATGTGCTTAACGATAGCTGCC|CGCTAGAAAGGGGCCCGCACTGTTCCTCCG
TTCATCGCTAACGAGCCCATGCCCCCTATT|CGCTAGAAAGGGGCCCGCACTGTTCTAGAA
GGGCCCGCACCTCCGCTAGAAAGGGGCCCG|TCCGCTAGAAAGGGGCCCGCACTGTTCCCA
CATACTGCTCGTCGGGCTTACCTCGTTCCC|GTTTCTGTAGAGATGCCGAGGAAAACAAGT
CATGTTTACTAGGGACGTGGGGCTTTCCCC|GTGATAGCCCGTCCAGTCGTAACGGTCACT
GAAAGGGGCCCGCACTGTTCAGAAAGGGGC|GCCTCTGACCTCCGCTAGAAAGGGGCCCGC
ACTTACGGGCCTCGTGTAATACAAGTTGAG|GCTACATTCGTCGTACGCATACTGCTCGTC
GTTCCGCGTAGCCTCTTCGAACCTCCGCTA|CGGCTAGCGTGGTTGGTAGCTTGTAGCTCC
ATTCGTCGTACGCATACTGCTCGTCGGGCT|AACGAGTATGCCGTTTCTGTAGAGATGCCG
CAAGTTCGTCCCAACCTGGAGATTAGGCTG|CTCGTAGCGTTCGTCAGGTGGAGAGCCAAT
CACCTCCGCTAGAAAGGGGCCCGCACTGTT|CCCACCTGCTGCATGCATATAGCAAACCCT
ACCTCCGCTAGAAAGGGGCCCGCACTGTTC|GGCATAGATCTACTGGCTGAGTTTCCTGGC
GACGGACTACATTAAGATTGCCACACCTCC|AGGGACGTGGGGCTTTCCCCGTTGGGCATA
ACAGTACAACCGACTTCGGCCCCATCTCCC|TGGGGTCTAAGGCGATGTGTTCAGGCCCCG
TTGAGGGTACACGTATCTGGTGTTCCGCGT|TCGTCGGGCTTACCTCGTTCCCGGCTAGCG
TCCAATGATTTCAGGTAACGAACATGCTAC|ACTGTTCAAGGGGCCCGCACTGTTCAGTTA
GCACTGTTCAGAAAGGGGCCCGCACTGTTC|CCGCTAGAAAGGGGCCCGCACCTCCGCTAG
GGCCCGCACTGTTCGCGCTGCACCTCCGCT|CTTATTAGCTGATCACGTGACCCACCTGCT
AAACAAGTTCGTCCCAACCTGGAGATTAGG|ACACTCGTAGCGTTCGTCAGGTGGAGAGCC
GCGTTGATGCCTCTGACCTCCGCTAGAAAG|GATTTCAGGTAACGAACATGCTACAACACC
CCCGCACTGTTCCCTCCGCTAGAAAGGGGC|CACCAGGCGCCGAAAGTATTTCGTTATACG
TGTTCGCGCTGCACCTCCGCTAGAAAGGGG|TGATCACGTGACCCACCTGCTGCATGCATA
CAACCGACTTCGGCCCCATCTCCCGTGAGG|CTAAGGCGATGTGTTCAGGCCCCGGCTCGG
GTAGCTTGTAGCTCCTAGCTTCCCACCAGG|AGATTAGGCTGACCTCCGCTACCTCCGCTA
TGATTTCAGGTAACGAACATGCTACAACAC|TCAAGGGGCCCGCACTGTTCAGTTAATCTC
GCTGCATGCATATAGCAAACCCTGGGTGAT|GAAAATGTCGACAGTACAACCGACTTCGGC
TAAGATTGCCACACCTCCGCTAGAAAGGGG|CTTTCCCCGTTGGGCATAGATCTACTGGCT
GAGTTTCCTGGCGACGAGTCCTTGTCCTTA|GGGCCCGCACTGTTCTAGGATAAGGAATTC
GGGCCCGCACTGTTCCCACCTCCGCACCTC|TGCTTAACGATAGCTGCCGGAGAAGTTTAA
TGCACCTCCGCTAGAAAGGGGCCCGCACTG|GACCCACCTGCTGCATGCATATAGCAAACC
CTAGAAAGGGGCCCGCACTGTTCTAGAACC|GCATTCACGTGGTTTAAATCCCGGCGCCTG
CTCCGCTAGAAAGGGGCCCGCACTGTTCGC|ACCTGCTGCATGCATATAGCAAACCCTGGG
ACAACCGACTTCGGCCCCATCTCCCGTGAG|TCTAAGGCGATGTGTTCAGGCCCCGGCTCG
AAATCCCGGCGCCTGACGTTACGCATCAGG|CACCTCCGCTAGAAAGGGGCCCGCACTGTT
TAGTTGCCTGGTATAACTTACGGGCCTCGT|CGCACTGTTCGTCGTGCTACATTCGTCGTA
CCTGGAGATTAGGCTGACCTCCGCTACCTC|CAGGTGGAGAGCCAATGCGACCACGTCGCG
CGCTAGAAAGGGGCCCGCACTGTTCAAGGG|GTTACGCATCAGGCGCGGAACGTTCGACGG
CTCCGCACCTCCGCTAGAAAGGGGCCCGCA|GAGAAGTTTAAATGCATTCACGTGGTTTAA
TTCAGGTAACGAACATGCTACAACACCTCC|GGGGCCCGCACTGTTCAGTTAATCTCGGGG
AAAGGGGCCCGCACTGTTCACTGTTCATCG|CACTGTTCCCACCTCCGCACCTCCGCTAGA
CTGTTCTAGAACCTCCGCTAGAAAGGGGCC|ATCCCGGCGCCTGACGTTACGCATCAGGCG
AGGGGCCCGCACTGTTCTAGGATAAGGAAT|CTCGGACCTCCGCTAGAAAGGGGCCCGCAC
TGCCCCCTATTTCTACCGTACGGTACGCTT|CTGTTCTAGAACCTCCGCTAGAAAGGGGCC
GCTGCACCTCCGCTAGAAAGGGGCCCGCAC|GTGACCCACCTGCTGCATGCATATAGCAAA
GTTTCCTGGCGACGAGTCCTTGTCCTTATT|GCCCGCACTGTTCTAGGATAAGGAATTCCA
GCGTTCGTCAGGTGGAGAGCCAATGCGACC|CCCTATTTCTACCGTACGGTACGCTTACAT
GGCCCGCACTGTTCGTCGTGCTACATTCGT|ACGTATGCGGATGGCGAAGCGCGCAACGAG
GGGCCTCGTGTAATACAAGTTGAGGGTACA|TTCGTCGTACGCATACTGCTCGTCGGGCTT
CGCACCTCCGCTAGAAAGGGGCCCGCACTG|TAGAAAGGGGCCCGCACTGTTCCCACCTCC
ACACCTCCGCTAGAAAGGGGCCCGCACTGT|TGGGCATAGATCTACTGGCTGAGTTTCCTG
GAAGCGCGCAACGAGTATGCCGTTTCTGTA|CTGTTCGGTGCGAACTTACGTAGTGAGTCT
CGGCCCCATCTCCCGTGAGGATGGACACAA|GTGTTCAGGCCCCGGCTCGGGGGCGCTGTG
ACGTGGTTTAAATCCCGGCGCCTGACGTTA|TTCGCGCTGCACCTCCGCTAGAAAGGGGCC
GTTCGTCCCAACCTGGAGATTAGGCTGACC|GTAGCGTTCGTCAGGTGGAGAGCCAATGCG
CGTTTCTGTAGAGATGCCGAGGAAAACAAG|TAGTGAGTCTTCCGTGTAGAACAACACTCG
CTACCGTACGGTACGCTTACATCCAATGAT|CTCCGCTAGAAAGGGGCCCGCACTGTTCAA
CTCGTGTAATACAAGTTGAGGGTACACGTA|TCGTACGCATACTGCTCGTCGGGCTTACCT
GCTAGCGTGGTTGGTAGCTTGTAGCTCCTA|CGTCCCAACCTGGAGATTAGGCTGACCTCC
TCGCGTTGATGCCTCTGACCTCCGCTAGAA|ATGATTTCAGGTAACGAACATGCTACAACA
GGGACGTGGGGCTTTCCCCGTTGGGCATAG|TCCAGTCGTAACGGTCACTATAGCAAACCT
CGTATGCGGATGGCGAAGCGCGCAACGAGT|GAAAGGGGCCCGCACTGTTCGGTGCGAACT
GTTCCCTCCGCTAGAAAGGGGCCCGCACTG|GCCGAAAGTATTTCGTTATACGTATGCGGA
TTCCGTGTAGAACAACACTCGTAGCGTTCG|TTCATCGCTAACGAGCCCATGCCCCCTATT
CCCGCACTGTTCTAGAACCTCCGCTAGAAA|GTTTAAATCCCGGCGCCTGACGTTACGCAT
ACCTCCGCTAGAAAGGGGCCCGCACTGTTC|TTGTAGCTCCTAGCTTCCCACCAGGCGCCG
CAAGGGGCCCGCACTGTTCAGTTAATCTCG|CGACGGACTACATTAAGATTGCCACACCTC
GAAAGGGGCCCGCACTGTTCACTGTTCATC|GCACTGTTCCCACCTCCGCACCTCCGCTAG
ATAGCAAACCCTGGGTGATAGCCCGTCCAG|CAGTACAACCGACTTCGGCCCCATCTCCCG
AAATGCATTCACGTGGTTTAAATCCCGGCG|GCCCGCACTGTTCGCGCTGCACCTCCGCTA
TAGAAAGGGGCCCGCACTGTTCTAGGATAA|GAAGCCTCGGACCTCCGCTAGAAAGGGGCC
GACCCACCTGCTGCATGCATATAGCAAACC|CAGTCCGGGGAAAATGTCGACAGTACAACC
CTGACCTCCGCTAGAAAGGGGCCCGCACCT|CGAACATGCTACAACACCTCCGCTAGAAAG
GCCCGCACTGTTCGGTGCGAACTTACGTAG|GCACCTCCGCTAGAAAGGGGCCCGCACTGT
TCAGAAAGGGGCCCGCACTGTTCGGTGCGA|AAAGGGGCCCGCACCTCCGCTAGAAAGGGG
TGACCCACCTGCTGCATGCATATAGCAAAC|CCAGTCCGGGGAAAATGTCGACAGTACAAC
GTGTTCCGCGTAGCCTCTTCGAACCTCCGC|CCCGGCTAGCGTGGTTGGTAGCTTGTAGCT
CAACGAGTATGCCGTTTCTGTAGAGATGCC|TGCGAACTTACGTAGTGAGTCTTCCGTGTA
AGGGACGTGGGGCTTTCCCCGTTGGGCATA|GTCCAGTCGTAACGGTCACTATAGCAAACC
GTAATACAAGTTGAGGGTACACGTATCTGG|CGCATACTGCTCGTCGGGCTTACCTCGTTC
CCGCTAGAAAGGGGCCCGCACTGTTCAGAA|GTTGATGCCTCTGACCTCCGCTAGAAAGGG
CACCTCCGCTAGAAAGGGGCCCGCACTGTT|CTCGGGGTAGCCCATGTGCTTAACGATAGC
CGCGTAGCCTCTTCGAACCTCCGCTAGAAA|TAGCGTGGTTGGTAGCTTGTAGCTCCTAGC
GGCCCGCACCTCCGCTAGAAAGGGGCCCGC|CCGCTAGAAAGGGGCCCGCACTGTTCCCAC
CCCGCACCTCCGCTAGAAAGGGGCCCGCAC|GCTAGAAAGGGGCCCGCACTGTTCCCACCT
CCGCACTGTTCCCTCCGCTAGAAAGGGGCC|ACCAGGCGCCGAAAGTATTTCGTTATACGT
AAAGGGGCCCGCACTGTTCGTCGTGCTACA|GTTATACGTATGCGGATGGCGAAGCGCGCA
GTTCGGTGCGAACTTACGTAGTGAGTCTTC|CTAGAAAGGGGCCCGCACTGTTCACTGTTC
TAGATAGTTGCCTGGTATAACTTACGGGCC|GGCCCGCACTGTTCGTCGTGCTACATTCGT
ACCCTGGGTGATAGCCCGTCCAGTCGTAAC|ACCGACTTCGGCCCCATCTCCCGTGAGGAT
CTACATTAAGATTGCCACACCTCCGCTAGA|GTGGGGCTTTCCCCGTTGGGCATAGATCTA
CGGTGCGAACTTACGTAGTGAGTCTTCCGT|GAAAGGGGCCCGCACTGTTCACTGTTCATC
AATCCCGGCGCCTGACGTTACGCATCAGGC|ACCTCCGCTAGAAAGGGGCCCGCACTGTTC
TCCGCTAGAAAGGGGCCCGCACTGTTCACT|GGGGCCCGCACTGTTCCCACCTCCGCACCT
GTAGTTAGATAGTTGCCTGGTATAACTTAC|AAAGGGGCCCGCACTGTTCGTCGTGCTACA
GTCGGGCTTACCTCGTTCCCGGCTAGCGTG|AGATGCCGAGGAAAACAAGTTCGTCCCAAC
GTAACGGTCACTATAGCAAACCTCCGCTAG|AGGATGGACACAAAACGAGATTGACCGGAA
CGTACGCATACTGCTCGTCGGGCTTACCTC|TATGCCGTTTCTGTAGAGATGCCGAGGAAA
TAATCTCGGGGTAGCCCATGTGCTTAACGA|CACACCTCCGCTAGAAAGGGGCCCGCACTG
TCGCATGTTTACTAGGGACGTGGGGCTTTC|TGGGTGATAGCCCGTCCAGTCGTAACGGTC
GAAAGGGGCCCGCACTGTTCGTCGTGCTAC|CGTTATACGTATGCGGATGGCGAAGCGCGC
ACGTCGCGTTGATGCCTCTGACCTCCGCTA|CCAATGATTTCAGGTAACGAACATGCTACA
AGAAAGGGGCCCGCACTGTTCCCTCCGCTA|CTAGCTTCCCACCAGGCGCCGAAAGTATTT
GGGCCCGCACTGTTCTAGAACCTCCGCTAG|GTGGTTTAAATCCCGGCGCCTGACGTTACG
GTTCCCGGCTAGCGTGGTTGGTAGCTTGTA|ACAAGTTCGTCCCAACCTGGAGATTAGGCT
CATGCATATAGCAAACCCTGGGTGATAGCC|ATGTCGACAGTACAACCGACTTCGGCCCCA
ATCCCGGCGCCTGACGTTACGCATCAGGCG|CCTCCGCTAGAAAGGGGCCCGCACTGTTCG
CTGTTCCTCCGCTAGAAAGGGGCCCGCACT|CCTGGCGACGAGTCCTTGTCCTTATTAGCT
CGACTTCGGCCCCATCTCCCGTGAGGATGG|GGCGATGTGTTCAGGCCCCGGCTCGGGGGC
TGAGGATGGACACAAAACGAGATTGACCGG|CTCGGGGGCGCTGTGGGAATGATCATAGTA
TCGACGGACTACATTAAGATTGCCACACCT|CTAGGGACGTGGGGCTTTCCCCGTTGGGCA
ATCACGTGACCCACCTGCTGCATGCATATA|ATCCTTCCAGTCCGGGGAAAATGTCGACAG
TAGCGTTCGTCAGGTGGAGAGCCAATGCGA|CCCCCTATTTCTACCGTACGGTACGCTTAC
GTTCGCGCTGCACCTCCGCTAGAAAGGGGC|GATCACGTGACCCACCTGCTGCATGCATAT
AAAATGTCGACAGTACAACCGACTTCGGCC|ATATTTCGCTGGGGTCTAAGGCGATGTGTT
CCGCACTGTTCCCACCTCCGCACCTCCGCT|TAACGATAGCTGCCGGAGAAGTTTAAATGC
GAAGTTTAAATGCATTCACGTGGTTTAAAT|GAAAGGGGCCCGCACTGTTCGCGCTGCACC
GGATGGCGAAGCGCGCAACGAGTATGCCGT|GCCCGCACTGTTCGGTGCGAACTTACGTAG
CGCATCAGGCGCGGAACGTTCGACGGACTA|CGCACTGTTCGCATGTTTACTAGGGACGTG
CGTTGATGCCTCTGACCTCCGCTAGAAAGG|ATTTCAGGTAACGAACATGCTACAACACCT
GGAGAAGTTTAAATGCATTCACGTGGTTTA|CTAGAAAGGGGCCCGCACTGTTCGCGCTGC
TAGCCCGTCCAGTCGTAACGGTCACTATAG|CCCCATCTCCCGTGAGGATGGACACAAAAC
GTTTCTGTAGAGATGCCGAGGAAAACAAGT|AGTGAGTCTTCCGTGTAGAACAACACTCGT
CCCGCACTGTTCACTGTTCATCGCTAACGA|CCCACCTCCGCACCTCCGCTAGAAAGGGGC
CGCTAGAAAGGGGCCCGCACTGTTCTAGAA|ATGCATTCACGTGGTTTAAATCCCGGCGCC
TTAGATAGTTGCCTGGTATAACTTACGGGC|GGGCCCGCACTGTTCGTCGTGCTACATTCG
TTCGAACCTCCGCTAGAAAGGGGCCCGCAC|GTAGCTTGTAGCTCCTAGCTTCCCACCAGG
TACGCTTACATCCAATGATTTCAGGTAACG|AGGGGCCCGCACTGTTCAAGGGGCCCGCAC
TGTTCAGTTAATCTCGGGGTAGCCCATGTG|AAGATTGCCACACCTCCGCTAGAAAGGGGC
GCGACGAGTCCTTGTCCTTATTAGCTGATC|TGTTCTAGGATAAGGAATTCCACAAAGATC
GGTCACTATAGCAAACCTCCGCTAGAAAGG|GGACACAAAACGAGATTGACCGGAAGCCTC
TGGTATAACTTACGGGCCTCGTGTAATACA|TCGTCGTGCTACATTCGTCGTACGCATACT
CTTGTCCTTATTAGCTGATCACGTGACCCA|TAAGGAATTCCACAAAGATCCTTCCAGTCC
CTGGAGATTAGGCTGACCTCCGCTACCTCC|AGGTGGAGAGCCAATGCGACCACGTCGCGT
ATAGCTGCCGGAGAAGTTTAAATGCATTCA|GTTCCTCCGCTAGAAAGGGGCCCGCACTGT
TACTGGCTGAGTTTCCTGGCGACGAGTCCT|CTAGAAAGGGGCCCGCACTGTTCTAGGATA
ACTGTTCGCATGTTTACTAGGGACGTGGGG|AACCCTGGGTGATAGCCCGTCCAGTCGTAA
GATGCCTCTGACCTCCGCTAGAAAGGGGCC|CAGGTAACGAACATGCTACAACACCTCCGC
ATGCTACAACACCTCCGCTAGAAAGGGGCC|TCAGTTAATCTCGGGGTAGCCCATGTGCTT
GCTTGTAGCTCCTAGCTTCCCACCAGGCGC|TTAGGCTGACCTCCGCTACCTCCGCTAGAA
AGAACCTCCGCTAGAAAGGGGCCCGCACTG|CGCCTGACGTTACGCATCAGGCGCGGAACG
ACGGTCACTATAGCAAACCTCCGCTAGAAA|ATGGACACAAAACGAGATTGACCGGAAGCC
TTCGGTGCGAACTTACGTAGTGAGTCTTCC|TAGAAAGGGGCCCGCACTGTTCACTGTTCA
AGTAGTTAGATAGTTGCCTGGTATAACTTA|GAAAGGGGCCCGCACTGTTCGTCGTGCTAC
GTAGAACAACACTCGTAGCGTTCGTCAGGT|GCTAACGAGCCCATGCCCCCTATTTCTACC
AGAAAGGGGCCCGCACTGTTCTAGAACCTC|ATTCACGTGGTTTAAATCCCGGCGCCTGAC
GGACGTGGGGCTTTCCCCGTTGGGCATAGA|CCAGTCGTAACGGTCACTATAGCAAACCTC
TGTTCCTCCGCTAGAAAGGGGCCCGCACTG|CTGGCGACGAGTCCTTGTCCTTATTAGCTG
TAGAAAGGGGCCCGCACCTCCGCTAGAAAG|CAACACCTCCGCTAGAAAGGGGCCCGCACT
CTCCGCTAGAAAGGGGCCCGCACTGTTCCC|GGGGTAGCCCATGTGCTTAACGATAGCTGC
AGGATAAGGAATTCCACAAAGATCCTTCCA|AGGGGCCCGCACTGTTCTTCGCTCCGCAGG
TCCGCTAGAAAGGGGCCCGCACTGTTCTAG|GACCGGAAGCCTCGGACCTCCGCTAGAAAG
GGCCCGCACTGTTCGGTGCGAACTTACGTA|CGCACCTCCGCTAGAAAGGGGCCCGCACTG
GGGCCCGCACTGTTCAGTTAATCTCGGGGT|GGACTACATTAAGATTGCCACACCTCCGCT
GATTTCAGGTAACGAACATGCTACAACACC|CAAGGGGCCCGCACTGTTCAGTTAATCTCG
TCGTTCCCGGCTAGCGTGGTTGGTAGCTTG|AAACAAGTTCGTCCCAACCTGGAGATTAGG
GGAAAACAAGTTCGTCCCAACCTGGAGATT|ACAACACTCGTAGCGTTCGTCAGGTGGAGA
TCGTGCTACATTCGTCGTACGCATACTGCT|GAAGCGCGCAACGAGTATGCCGTTTCTGTA
CGCATACTGCTCGTCGGGCTTACCTCGTTC|CCGTTTCTGTAGAGATGCCGAGGAAAACAA
ACATCCAATGATTTCAGGTAACGAACATGC|CGCACTGTTCAAGGGGCCCGCACTGTTCAG
ATACGTATGCGGATGGCGAAGCGCGCAACG|TCAGAAAGGGGCCCGCACTGTTCGGTGCGA
CGTCGTGCTACATTCGTCGTACGCATACTG|GCGAAGCGCGCAACGAGTATGCCGTTTCTG
GCATACTGCTCGTCGGGCTTACCTCGTTCC|CGTTTCTGTAGAGATGCCGAGGAAAACAAG
GAAAGGGGCCCGCACTGTTCGCGCTGCACC|CTTGTCCTTATTAGCTGATCACGTGACCCA
CGAACATGCTACAACACCTCCGCTAGAAAG|ACTGTTCAGTTAATCTCGGGGTAGCCCATG
ATGCCGAGGAAAACAAGTTCGTCCCAACCT|GTGTAGAACAACACTCGTAGCGTTCGTCAG
GAGTCCTTGTCCTTATTAGCTGATCACGTG|TAGGATAAGGAATTCCACAAAGATCCTTCC
CTGTTCAAGGGGCCCGCACTGTTCAGTTAA|ACGTTCGACGGACTACATTAAGATTGCCAC
TGATGCCTCTGACCTCCGCTAGAAAGGGGC|TCAGGTAACGAACATGCTACAACACCTCCG
TCAGGTGGAGAGCCAATGCGACCACGTCGC|TCTACCGTACGGTACGCTTACATCCAATGA
CTACAACACCTCCGCTAGAAAGGGGCCCGC|GTTAATCTCGGGGTAGCCCATGTGCTTAAC
ACGTGACCCACCTGCTGCATGCATATAGCA|CTTCCAGTCCGGGGAAAATGTCGACAGTAC
AAATGTCGACAGTACAACCGACTTCGGCCC|TATTTCGCTGGGGTCTAAGGCGATGTGTTC
CTATAGCAAACCTCCGCTAGAAAGGGGCCC|CAAAACGAGATTGACCGGAAGCCTCGGACC
TTACGTAGTGAGTCTTCCGTGTAGAACAAC|CGCACTGTTCACTGTTCATCGCTAACGAGC
AGATGCCGAGGAAAACAAGTTCGTCCCAAC|CCGTGTAGAACAACACTCGTAGCGTTCGTC
CTAGAAAGGGGCCCGCACCTCCGCTAGAAA|ACAACACCTCCGCTAGAAAGGGGCCCGCAC
ATCTACTGGCTGAGTTTCCTGGCGACGAGT|CCGCTAGAAAGGGGCCCGCACTGTTCTAGG
CAAACCCTGGGTGATAGCCCGTCCAGTCGT|ACAACCGACTTCGGCCCCATCTCCCGTGAG
CGCGTTGATGCCTCTGACCTCCGCTAGAAA|TGATTTCAGGTAACGAACATGCTACAACAC
GTTTAAATGCATTCACGTGGTTTAAATCCC|AGGGGCCCGCACTGTTCGCGCTGCACCTCC
AGTTGCCTGGTATAACTTACGGGCCTCGTG|GCACTGTTCGTCGTGCTACATTCGTCGTAC
CTGTTCGGTGCGAACTTACGTAGTGAGTCT|CGCTAGAAAGGGGCCCGCACTGTTCACTGT
GCACTGTTCCTCCGCTAGAAAGGGGCCCGC|TTTCCTGGCGACGAGTCCTTGTCCTTATTA
TCCCACCTCCGCACCTCCGCTAGAAAGGGG|CTGCCGGAGAAGTTTAAATGCATTCACGTG
ACTGTTCAGAAAGGGGCCCGCACTGTTCGG|GCTAGAAAGGGGCCCGCACCTCCGCTAGAA
TGCCTCTGACCTCCGCTAGAAAGGGGCCCG|GGTAACGAACATGCTACAACACCTCCGCTA
GCCCGCACTGTTCCCACCTCCGCACCTCCG|CTTAACGATAGCTGCCGGAGAAGTTTAAAT
AACACCTCCGCTAGAAAGGGGCCCGCACTG|ATCTCGGGGTAGCCCATGTGCTTAACGATA
TCGTGTAATACAAGTTGAGGGTACACGTAT|CGTACGCATACTGCTCGTCGGGCTTACCTC
GTTTACTAGGGACGTGGGGCTTTCCCCGTT|ATAGCCCGTCCAGTCGTAACGGTCACTATA
AAGATTGCCACACCTCCGCTAGAAAGGGGC|TTTCCCCGTTGGGCATAGATCTACTGGCTG
GCACTGTTCAAGGGGCCCGCACTGTTCAGT|GGAACGTTCGACGGACTACATTAAGATTGC
AGAAAGGGGCCCGCACTGTTCGCGCTGCAC|CCTTGTCCTTATTAGCTGATCACGTGACCC
CGCTACCTCCGCTAGAAAGGGGCCCGCACT|CACGTCGCGTTGATGCCTCTGACCTCCGCT
CTGGCTGAGTTTCCTGGCGACGAGTCCTTG|AGAAAGGGGCCCGCACTGTTCTAGGATAAG
CGCACTGTTCGCGCTGCACCTCCGCTAGAA|TTAGCTGATCACGTGACCCACCTGCTGCAT
CTGCTCGTCGGGCTTACCTCGTTCCCGGCT|CTGTAGAGATGCCGAGGAAAACAAGTTCGT
ACCTCCGCTACCTCCGCTAGAAAGGGGCCC|GCGACCACGTCGCGTTGATGCCTCTGACCT
AAGTTCGTCCCAACCTGGAGATTAGGCTGA|TCGTAGCGTTCGTCAGGTGGAGAGCCAATG
TGTTCCGCGTAGCCTCTTCGAACCTCCGCT|CCGGCTAGCGTGGTTGGTAGCTTGTAGCTC
GGTAGCTTGTAGCTCCTAGCTTCCCACCAG|GAGATTAGGCTGACCTCCGCTACCTCCGCT
TATTTCTACCGTACGGTACGCTTACATCCA|AGAACCTCCGCTAGAAAGGGGCCCGCACTG
GCTCGTCGGGCTTACCTCGTTCCCGGCTAG|GTAGAGATGCCGAGGAAAACAAGTTCGTCC
ACTGTTCGCGCTGCACCTCCGCTAGAAAGG|GCTGATCACGTGACCCACCTGCTGCATGCA
GACTTCGGCCCCATCTCCCGTGAGGATGGA|GCGATGTGTTCAGGCCCCGGCTCGGGGGCG
CGCACTGTTCGTCGTGCTACATTCGTCGTA|ATGCGGATGGCGAAGCGCGCAACGAGTATG
CTGTTCGCATGTTTACTAGGGACGTGGGGC|ACCCTGGGTGATAGCCCGTCCAGTCGTAAC
ACTGTTCAAGGGGCCCGCACTGTTCAGTTA|AACGTTCGACGGACTACATTAAGATTGCCA
GAAAGGGGCCCGCACTGTTCCCACCTCCGC|CCATGTGCTTAACGATAGCTGCCGGAGAAG
TGTCGACAGTACAACCGACTTCGGCCCCAT|TTCGCTGGGGTCTAAGGCGATGTGTTCAGG
AGCGTGGTTGGTAGCTTGTAGCTCCTAGCT|CCCAACCTGGAGATTAGGCTGACCTCCGCT
TCGAACCTCCGCTAGAAAGGGGCCCGCACT|TAGCTTGTAGCTCCTAGCTTCCCACCAGGC
TGATCACGTGACCCACCTGCTGCATGCATA|AGATCCTTCCAGTCCGGGGAAAATGTCGAC
GTTCCTCCGCTAGAAAGGGGCCCGCACTGT|TGGCGACGAGTCCTTGTCCTTATTAGCTGA
CATATAGCAAACCCTGGGTGATAGCCCGTC|CGACAGTACAACCGACTTCGGCCCCATCTC
GGTGCGAACTTACGTAGTGAGTCTTCCGTG|AAAGGGGCCCGCACTGTTCACTGTTCATCG
GACGTTACGCATCAGGCGCGGAACGTTCGA|AGGGGCCCGCACTGTTCGCATGTTTACTAG
CACTGTTCCCTCCGCTAGAAAGGGGCCCGC|AGGCGCCGAAAGTATTTCGTTATACGTATG
GGCTGAGTTTCCTGGCGACGAGTCCTTGTC|AAAGGGGCCCGCACTGTTCTAGGATAAGGA
CAATGATTTCAGGTAACGAACATGCTACAA|TGTTCAAGGGGCCCGCACTGTTCAGTTAAT
CCCCGTTGGGCATAGATCTACTGGCTGAGT|CACTATAGCAAACCTCCGCTAGAAAGGGGC
TGACCTCCGCTAGAAAGGGGCCCGCACCTC|GAACATGCTACAACACCTCCGCTAGAAAGG
TTGATGCCTCTGACCTCCGCTAGAAAGGGG|TTCAGGTAACGAACATGCTACAACACCTCC
AGGGTACACGTATCTGGTGTTCCGCGTAGC|TCGGGCTTACCTCGTTCCCGGCTAGCGTGG
CGAACCTCCGCTAGAAAGGGGCCCGCACTG|AGCTTGTAGCTCCTAGCTTCCCACCAGGCG
TAGCAAACCTCCGCTAGAAAGGGGCCCGCA|AACGAGATTGACCGGAAGCCTCGGACCTCC
CGGACTACATTAAGATTGCCACACCTCCGC|GGACGTGGGGCTTTCCCCGTTGGGCATAGA
AGAAAGGGGCCCGCACTGTTCCCACCTCCG|CCCATGTGCTTAACGATAGCTGCCGGAGAA
CCCGGCGCCTGACGTTACGCATCAGGCGCG|TCCGCTAGAAAGGGGCCCGCACTGTTCGCA
AAGGGGCCCGCACTGTTCCCACCTCCGCAC|ATGTGCTTAACGATAGCTGCCGGAGAAGTT
TACTGCTCGTCGGGCTTACCTCGTTCCCGG|TTCTGTAGAGATGCCGAGGAAAACAAGTTC
CGCTAGAAAGGGGCCCGCACTGTTCGTCGT|TATTTCGTTATACGTATGCGGATGGCGAAG
CGTTACGCATCAGGCGCGGAACGTTCGACG|GGGCCCGCACTGTTCGCATGTTTACTAGGG
TGTTCGGTGCGAACTTACGTAGTGAGTCTT|GCTAGAAAGGGGCCCGCACTGTTCACTGTT
CGTTCCCGGCTAGCGTGGTTGGTAGCTTGT|AACAAGTTCGTCCCAACCTGGAGATTAGGC
TTCCCGGCTAGCGTGGTTGGTAGCTTGTAG|CAAGTTCGTCCCAACCTGGAGATTAGGCTG
ACTCGTAGCGTTCGTCAGGTGGAGAGCCAA|CCATGCCCCCTATTTCTACCGTACGGTACG
ATTAGCTGATCACGTGACCCACCTGCTGCA|CCACAAAGATCCTTCCAGTCCGGGGAAAAT
CCCGCACTGTTCGTCGTGCTACATTCGTCG|GTATGCGGATGGCGAAGCGCGCAACGAGTA
CGACAGTACAACCGACTTCGGCCCCATCTC|GCTGGGGTCTAAGGCGATGTGTTCAGGCCC
CCCGCACTGTTCAAGGGGCCCGCACTGTTC|CGCGGAACGTTCGACGGACTACATTAAGAT
TCCGCTAGAAAGGGGCCCGCACTGTTCAGA|CGTTGATGCCTCTGACCTCCGCTAGAAAGG
ACCTCCGCTAGAAAGGGGCCCGCACCTCCG|ACATGCTACAACACCTCCGCTAGAAAGGGG
GTAGCTCCTAGCTTCCCACCAGGCGCCGAA|GCTGACCTCCGCTACCTCCGCTAGAAAGGG
ACGCATACTGCTCGTCGGGCTTACCTCGTT|GCCGTTTCTGTAGAGATGCCGAGGAAAACA
GGCGCCTGACGTTACGCATCAGGCGCGGAA|GCTAGAAAGGGGCCCGCACTGTTCGCATGT
CGTGGTTGGTAGCTTGTAGCTCCTAGCTTC|CAACCTGGAGATTAGGCTGACCTCCGCTAC
GGGGCCCGCACTGTTCAAGGGGCCCGCACT|CAGGCGCGGAACGTTCGACGGACTACATTA
CAAGTTGAGGGTACACGTATCTGGTGTTCC|CTGCTCGTCGGGCTTACCTCGTTCCCGGCT
TTCCCCGTTGGGCATAGATCTACTGGCTGA|GTCACTATAGCAAACCTCCGCTAGAAAGGG
CCACGTCGCGTTGATGCCTCTGACCTCCGC|ATCCAATGATTTCAGGTAACGAACATGCTA
CGGATGGCGAAGCGCGCAACGAGTATGCCG|GGCCCGCACTGTTCGGTGCGAACTTACGTA
CTTGTAGCTCCTAGCTTCCCACCAGGCGCC|TAGGCTGACCTCCGCTACCTCCGCTAGAAA
AGCTTCCCACCAGGCGCCGAAAGTATTTCG|CGCTACCTCCGCTAGAAAGGGGCCCGCACT
ATGCCCCCTATTTCTACCGTACGGTACGCT|ACTGTTCTAGAACCTCCGCTAGAAAGGGGC
GAATTCCACAAAGATCCTTCCAGTCCGGGG|GCACTGTTCTTCGCTCCGCAGGTCAACTTC
CGGGCTTACCTCGTTCCCGGCTAGCGTGGT|ATGCCGAGGAAAACAAGTTCGTCCCAACCT
CCTCCGCTAGAAAGGGGCCCGCACTGTTCT|TTGACCGGAAGCCTCGGACCTCCGCTAGAA
GCACTGTTCCCTCCGCTAGAAAGGGGCCCG|CAGGCGCCGAAAGTATTTCGTTATACGTAT
TCTTCGAACCTCCGCTAGAAAGGGGCCCGC|TGGTAGCTTGTAGCTCCTAGCTTCCCACCA
ATTAAGATTGCCACACCTCCGCTAGAAAGG|GGCTTTCCCCGTTGGGCATAGATCTACTGG
CCGCTAGAAAGGGGCCCGCACTGTTCGTCG|GTATTTCGTTATACGTATGCGGATGGCGAA
CCACCTGCTGCATGCATATAGCAAACCCTG|TCCGGGGAAAATGTCGACAGTACAACCGAC
CCATGTGCTTAACGATAGCTGCCGGAGAAG|AAGGGGCCCGCACTGTTCCTCCGCTAGAAA
CCGCACTGTTCGGTGCGAACTTACGTAGTG|ACCTCCGCTAGAAAGGGGCCCGCACTGTTC
CCTCCGCTAGAAAGGGGCCCGCACTGTTCG|CGACGAGTCCTTGTCCTTATTAGCTGATCA
GCCTGACGTTACGCATCAGGCGCGGAACGT|AGAAAGGGGCCCGCACTGTTCGCATGTTTA
TGTTCATCGCTAACGAGCCCATGCCCCCTA|TCCGCTAGAAAGGGGCCCGCACTGTTCTAG
GCTAGAAAGGGGCCCGCACCTCCGCTAGAA|TACAACACCTCCGCTAGAAAGGGGCCCGCA
AGGGGCCCGCACTGTTCACTGTTCATCGCT|CTGTTCCCACCTCCGCACCTCCGCTAGAAA
TTCTAGGATAAGGAATTCCACAAAGATCCT|AGAAAGGGGCCCGCACTGTTCTTCGCTCCG
CACCTGCTGCATGCATATAGCAAACCCTGG|CCGGGGAAAATGTCGACAGTACAACCGACT
TTCCTCCGCTAGAAAGGGGCCCGCACTGTT|GGCGACGAGTCCTTGTCCTTATTAGCTGAT
GGGGCCCGCACTGTTCAGAAAGGGGCCCGC|CTGACCTCCGCTAGAAAGGGGCCCGCACCT
GCCTGGTATAACTTACGGGCCTCGTGTAAT|TGTTCGTCGTGCTACATTCGTCGTACGCAT
CCGGGGAAAATGTCGACAGTACAACCGACT|AACTTCATATTTCGCTGGGGTCTAAGGCGA
CTGGTGTTCCGCGTAGCCTCTTCGAACCTC|GTTCCCGGCTAGCGTGGTTGGTAGCTTGTA
CACAAAGATCCTTCCAGTCCGGGGAAAATG|TTCTTCGCTCCGCAGGTCAACTTCATATTT
TTCACTGTTCATCGCTAACGAGCCCATGCC|GCACCTCCGCTAGAAAGGGGCCCGCACTGT
CCTATTTCTACCGTACGGTACGCTTACATC|CTAGAACCTCCGCTAGAAAGGGGCCCGCAC
CCAACCTGGAGATTAGGCTGACCTCCGCTA|TCGTCAGGTGGAGAGCCAATGCGACCACGT
AAAGGGGCCCGCACTGTTCCTCCGCTAGAA|ACTGGCTGAGTTTCCTGGCGACGAGTCCTT
GAACTTACGTAGTGAGTCTTCCGTGTAGAA|GGCCCGCACTGTTCACTGTTCATCGCTAAC
ACCTCCGCTAGAAAGGGGCCCGCACTGTTC|TTTAAATGCATTCACGTGGTTTAAATCCCG
CACTGTTCCCACCTCCGCACCTCCGCTAGA|CGATAGCTGCCGGAGAAGTTTAAATGCATT
TAGAAAGGGGCCCGCACTGTTCGCATGTTT|TGCATGCATATAGCAAACCCTGGGTGATAG
AGTCGTAACGGTCACTATAGCAAACCTCCG|CGTGAGGATGGACACAAAACGAGATTGACC
GGCTGACCTCCGCTACCTCCGCTAGAAAGG|CCAATGCGACCACGTCGCGTTGATGCCTCT
GAAAGGGGCCCGCACTGTTCCTCCGCTAGA|TACTGGCTGAGTTTCCTGGCGACGAGTCCT
CGCACTGTTCAGAAAGGGGCCCGCACTGTT|TCCGCTAGAAAGGGGCCCGCACCTCCGCTA
AAGGGGCCCGCACTGTTCAGTTAATCTCGG|GACGGACTACATTAAGATTGCCACACCTCC
CTGACGTTACGCATCAGGCGCGGAACGTTC|AAAGGGGCCCGCACTGTTCGCATGTTTACT
TTTAAATGCATTCACGTGGTTTAAATCCCG|GGGGCCCGCACTGTTCGCGCTGCACCTCCG
CGTGACCCACCTGCTGCATGCATATAGCAA|TTCCAGTCCGGGGAAAATGTCGACAGTACA
AGTCCGGGGAAAATGTCGACAGTACAACCG|GTCAACTTCATATTTCGCTGGGGTCTAAGG
CTCCGCTAGAAAGGGGCCCGCACTGTTCAG|GCGTTGATGCCTCTGACCTCCGCTAGAAAG
AGAGATGCCGAGGAAAACAAGTTCGTCCCA|TTCCGTGTAGAACAACACTCGTAGCGTTCG
GATAGCTGCCGGAGAAGTTTAAATGCATTC|TGTTCCTCCGCTAGAAAGGGGCCCGCACTG
GTAACGAACATGCTACAACACCTCCGCTAG|CCGCACTGTTCAGTTAATCTCGGGGTAGCC
AAAGGGGCCCGCACTGTTCGCATGTTTACT|ATGCATATAGCAAACCCTGGGTGATAGCCC
TCTGTAGAGATGCCGAGGAAAACAAGTTCG|GAGTCTTCCGTGTAGAACAACACTCGTAGC
ATAAGGAATTCCACAAAGATCCTTCCAGTC|GGCCCGCACTGTTCTTCGCTCCGCAGGTCA
CTCCGCTAGAAAGGGGCCCGCACTGTTCCT|CATAGATCTACTGGCTGAGTTTCCTGGCGA
AGGATGGACACAAAACGAGATTGACCGGAA|CGGGGGCGCTGTGGGAATGATCATAGTAGG
AAGTATTTCGTTATACGTATGCGGATGGCG|GGCCCGCACTGTTCAGAAAGGGGCCCGCAC
CCGCTAGAAAGGGGCCCGCACTGTTCGCAT|CTGCTGCATGCATATAGCAAACCCTGGGTG
GTCGTGCTACATTCGTCGTACGCATACTGC|CGAAGCGCGCAACGAGTATGCCGTTTCTGT
TCCGCTAGAAAGGGGCCCGCACTGTTCCTC|ATAGATCTACTGGCTGAGTTTCCTGGCGAC
TGCCACACCTCCGCTAGAAAGGGGCCCGCA|CCGTTGGGCATAGATCTACTGGCTGAGTTT
TAGCGTGGTTGGTAGCTTGTAGCTCCTAGC|TCCCAACCTGGAGATTAGGCTGACCTCCGC
GCCAATGCGACCACGTCGCGTTGATGCCTC|GTACGCTTACATCCAATGATTTCAGGTAAC
TTAGGCTGACCTCCGCTACCTCCGCTAGAA|GAGCCAATGCGACCACGTCGCGTTGATGCC
TGCGACCACGTCGCGTTGATGCCTCTGACC|CTTACATCCAATGATTTCAGGTAACGAACA
CGGTCACTATAGCAAACCTCCGCTAGAAAG|TGGACACAAAACGAGATTGACCGGAAGCCT
GCTAGAAAGGGGCCCGCACTGTTCGCATGT|GCTGCATGCATATAGCAAACCCTGGGTGAT
CCCGTCCAGTCGTAACGGTCACTATAGCAA|CATCTCCCGTGAGGATGGACACAAAACGAG
GGGGCCCGCACTGTTCGTCGTGCTACATTC|ATACGTATGCGGATGGCGAAGCGCGCAACG
GCCCGCACTGTTCAGAAAGGGGCCCGCACT|ACCTCCGCTAGAAAGGGGCCCGCACCTCCG
CCGCACTGTTCTAGAACCTCCGCTAGAAAG|TTTAAATCCCGGCGCCTGACGTTACGCATC
GCCCGTCCAGTCGTAACGGTCACTATAGCA|CCATCTCCCGTGAGGATGGACACAAAACGA
CGCACTGTTCAAGGGGCCCGCACTGTTCAG|CGGAACGTTCGACGGACTACATTAAGATTG
ATACTGCTCGTCGGGCTTACCTCGTTCCCG|TTTCTGTAGAGATGCCGAGGAAAACAAGTT
TCTACTGGCTGAGTTTCCTGGCGACGAGTC|CGCTAGAAAGGGGCCCGCACTGTTCTAGGA
TTACTAGGGACGTGGGGCTTTCCCCGTTGG|AGCCCGTCCAGTCGTAACGGTCACTATAGC
GGGGCCCGCACTGTTCGGTGCGAACTTACG|CCCGCACCTCCGCTAGAAAGGGGCCCGCAC
GAGATTAGGCTGACCTCCGCTACCTCCGCT|TGGAGAGCCAATGCGACCACGTCGCGTTGA
GCCCGCACTGTTCAGTTAATCTCGGGGTAG|ACTACATTAAGATTGCCACACCTCCGCTAG
GCACCTCCGCTAGAAAGGGGCCCGCACTGT|AGAAAGGGGCCCGCACTGTTCCCACCTCCG
GCTAACGAGCCCATGCCCCCTATTTCTACC|AAAGGGGCCCGCACTGTTCTAGAACCTCCG
AAGTTGAGGGTACACGTATCTGGTGTTCCG|TGCTCGTCGGGCTTACCTCGTTCCCGGCTA
ACTGTTCATCGCTAACGAGCCCATGCCCCC|CCTCCGCTAGAAAGGGGCCCGCACTGTTCT
GGGGCCCGCACTGTTCTAGGATAAGGAATT|TCGGACCTCCGCTAGAAAGGGGCCCGCACT
AAAGGGGCCCGCACTGTTCAGAAAGGGGCC|CCTCTGACCTCCGCTAGAAAGGGGCCCGCA
TTTAAATCCCGGCGCCTGACGTTACGCATC|CTGCACCTCCGCTAGAAAGGGGCCCGCACT
TAGTAGTTAGATAGTTGCCTGGTATAACTT|AGAAAGGGGCCCGCACTGTTCGTCGTGCTA
GTCCTTATTAGCTGATCACGTGACCCACCT|GGAATTCCACAAAGATCCTTCCAGTCCGGG
CGCACTGTTCCCTCCGCTAGAAAGGGGCCC|CCAGGCGCCGAAAGTATTTCGTTATACGTA
GATAGTTGCCTGGTATAACTTACGGGCCTC|CCCGCACTGTTCGTCGTGCTACATTCGTCG
TTTCTACCGTACGGTACGCTTACATCCAAT|AACCTCCGCTAGAAAGGGGCCCGCACTGTT
CCGCACTGTTCGCGCTGCACCTCCGCTAGA|ATTAGCTGATCACGTGACCCACCTGCTGCA
GGGGCCCGCACTGTTCAGTTAATCTCGGGG|CGGACTACATTAAGATTGCCACACCTCCGC
TTAAGATTGCCACACCTCCGCTAGAAAGGG|GCTTTCCCCGTTGGGCATAGATCTACTGGC
TGCATGCATATAGCAAACCCTGGGTGATAG|AAATGTCGACAGTACAACCGACTTCGGCCC
ATGTTTACTAGGGACGTGGGGCTTTCCCCG|TGATAGCCCGTCCAGTCGTAACGGTCACTA
CCAGTCCGGGGAAAATGTCGACAGTACAAC|AGGTCAACTTCATATTTCGCTGGGGTCTAA
AAGGGGCCCGCACTGTTCACTGTTCATCGC|ACTGTTCCCACCTCCGCACCTCCGCTAGAA
GACCACGTCGCGTTGATGCCTCTGACCTCC|ACATCCAATGATTTCAGGTAACGAACATGC
GCTAGAAAGGGGCCCGCACTGTTCCTCCGC|GATCTACTGGCTGAGTTTCCTGGCGACGAG
CCGAGGAAAACAAGTTCGTCCCAACCTGGA|TAGAACAACACTCGTAGCGTTCGTCAGGTG
ATGCATATAGCAAACCCTGGGTGATAGCCC|TGTCGACAGTACAACCGACTTCGGCCCCAT
AATCTCGGGGTAGCCCATGTGCTTAACGAT|ACACCTCCGCTAGAAAGGGGCCCGCACTGT
GGATAAGGAATTCCACAAAGATCCTTCCAG|GGGGCCCGCACTGTTCTTCGCTCCGCAGGT
CCCGCACTGTTCCTCCGCTAGAAAGGGGCC|GAGTTTCCTGGCGACGAGTCCTTGTCCTTA
GAAAGTATTTCGTTATACGTATGCGGATGG|GGGGCCCGCACTGTTCAGAAAGGGGCCCGC
AGGGGCCCGCACTGTTCAAGGGGCCCGCAC|TCAGGCGCGGAACGTTCGACGGACTACATT
ACTGCTCGTCGGGCTTACCTCGTTCCCGGC|TCTGTAGAGATGCCGAGGAAAACAAGTTCG
CTAGAAAGGGGCCCGCACTGTTCGTCGTGC|TTTCGTTATACGTATGCGGATGGCGAAGCG
CGCTAGAAAGGGGCCCGCACTGTTCGCGCT|GAGTCCTTGTCCTTATTAGCTGATCACGTG
GGGGCCCGCACTGTTCGCGCTGCACCTCCG|TCCTTATTAGCTGATCACGTGACCCACCTG
CTACATTCGTCGTACGCATACTGCTCGTCG|GCGCAACGAGTATGCCGTTTCTGTAGAGAT
ATTGCCACACCTCCGCTAGAAAGGGGCCCG|CCCCGTTGGGCATAGATCTACTGGCTGAGT
CTTCGGCCCCATCTCCCGTGAGGATGGACA|GATGTGTTCAGGCCCCGGCTCGGGGGCGCT
TTTCCTGGCGACGAGTCCTTGTCCTTATTA|CCCGCACTGTTCTAGGATAAGGAATTCCAC
AGATTAGGCTGACCTCCGCTACCTCCGCTA|GGAGAGCCAATGCGACCACGTCGCGTTGAT
CGTTATACGTATGCGGATGGCGAAGCGCGC|CTGTTCAGAAAGGGGCCCGCACTGTTCGGT
AAACCCTGGGTGATAGCCCGTCCAGTCGTA|CAACCGACTTCGGCCCCATCTCCCGTGAGG
ACCTCCGCTAGAAAGGGGCCCGCACTGTTC|CCACCTGCTGCATGCATATAGCAAACCCTG
TACATCCAATGATTTCAGGTAACGAACATG|CCGCACTGTTCAAGGGGCCCGCACTGTTCA
CCAATGCGACCACGTCGCGTTGATGCCTCT|TACGCTTACATCCAATGATTTCAGGTAACG
GGTACGCTTACATCCAATGATTTCAGGTAA|AAAGGGGCCCGCACTGTTCAAGGGGCCCGC
TGATAGCCCGTCCAGTCGTAACGGTCACTA|CGGCCCCATCTCCCGTGAGGATGGACACAA
GGATGGACACAAAACGAGATTGACCGGAAG|GGGGGCGCTGTGGGAATGATCATAGTAGGC
CAGGCGCCGAAAGTATTTCGTTATACGTAT|GCTAGAAAGGGGCCCGCACTGTTCAGAAAG
CTCGTCGGGCTTACCTCGTTCCCGGCTAGC|TAGAGATGCCGAGGAAAACAAGTTCGTCCC
GCTTAACGATAGCTGCCGGAGAAGTTTAAA|CCCGCACTGTTCCTCCGCTAGAAAGGGGCC
TCGTCAGGTGGAGAGCCAATGCGACCACGT|ATTTCTACCGTACGGTACGCTTACATCCAA
AGAGCCAATGCGACCACGTCGCGTTGATGC|ACGGTACGCTTACATCCAATGATTTCAGGT
ATTTCAGGTAACGAACATGCTACAACACCT|AAGGGGCCCGCACTGTTCAGTTAATCTCGG
TAGAAAGGGGCCCGCACTGTTCGCGCTGCA|TCCTTGTCCTTATTAGCTGATCACGTGACC
GTTCTAGGATAAGGAATTCCACAAAGATCC|TAGAAAGGGGCCCGCACTGTTCTTCGCTCC
CCGCTAGAAAGGGGCCCGCACTGTTCAAGG|CGTTACGCATCAGGCGCGGAACGTTCGACG
CGTTCGTCAGGTGGAGAGCCAATGCGACCA|CCTATTTCTACCGTACGGTACGCTTACATC
TGTAGAACAACACTCGTAGCGTTCGTCAGG|CGCTAACGAGCCCATGCCCCCTATTTCTAC
ACGAACATGCTACAACACCTCCGCTAGAAA|CACTGTTCAGTTAATCTCGGGGTAGCCCAT
ACCTCCGCTAGAAAGGGGCCCGCACTGTTC|TCGCGTTGATGCCTCTGACCTCCGCTAGAA
ATTAGGCTGACCTCCGCTACCTCCGCTAGA|AGAGCCAATGCGACCACGTCGCGTTGATGC
CTAGAAAGGGGCCCGCACTGTTCGCGCTGC|GTCCTTGTCCTTATTAGCTGATCACGTGAC
GGGCATAGATCTACTGGCTGAGTTTCCTGG|GCAAACCTCCGCTAGAAAGGGGCCCGCACT
CTTTCCCCGTTGGGCATAGATCTACTGGCT|CGGTCACTATAGCAAACCTCCGCTAGAAAG
GGCCCGCACTGTTCACTGTTCATCGCTAAC|TTCCCACCTCCGCACCTCCGCTAGAAAGGG
GATAGCCCGTCCAGTCGTAACGGTCACTAT|GGCCCCATCTCCCGTGAGGATGGACACAAA
ATGCCGTTTCTGTAGAGATGCCGAGGAAAA|TACGTAGTGAGTCTTCCGTGTAGAACAACA
TGACGTTACGCATCAGGCGCGGAACGTTCG|AAGGGGCCCGCACTGTTCGCATGTTTACTA
GTCCTTGTCCTTATTAGCTGATCACGTGAC|GGATAAGGAATTCCACAAAGATCCTTCCAG
CGCATGTTTACTAGGGACGTGGGGCTTTCC|GGGTGATAGCCCGTCCAGTCGTAACGGTCA
CCCGCACTGTTCTAGGATAAGGAATTCCAC|ACCTCCGCTAGAAAGGGGCCCGCACTGTTC
CCTCCGCACCTCCGCTAGAAAGGGGCCCGC|GGAGAAGTTTAAATGCATTCACGTGGTTTA
AGGGGCCCGCACTGTTCAGTTAATCTCGGG|ACGGACTACATTAAGATTGCCACACCTCCG
GCCCGCACTGTTCGCATGTTTACTAGGGAC|ATAGCAAACCCTGGGTGATAGCCCGTCCAG
GCCCATGCCCCCTATTTCTACCGTACGGTA|CCGCACTGTTCTAGAACCTCCGCTAGAAAG
TTAGCTGATCACGTGACCCACCTGCTGCAT|CACAAAGATCCTTCCAGTCCGGGGAAAATG
CCGCTAGAAAGGGGCCCGCACTGTTCACTG|GGGCCCGCACTGTTCCCACCTCCGCACCTC
GGGCCCGCACTGTTCCCTCCGCTAGAAAGG|TCCCACCAGGCGCCGAAAGTATTTCGTTAT
GCTTACATCCAATGATTTCAGGTAACGAAC|GGCCCGCACTGTTCAAGGGGCCCGCACTGT
AACCTCCGCTAGAAAGGGGCCCGCACTGTT|CTTGTAGCTCCTAGCTTCCCACCAGGCGCC
ACGCATCAGGCGCGGAACGTTCGACGGACT|CCGCACTGTTCGCATGTTTACTAGGGACGT
ACATTAAGATTGCCACACCTCCGCTAGAAA|GGGGCTTTCCCCGTTGGGCATAGATCTACT
CTAGAAAGGGGCCCGCACTGTTCACTGTTC|CCCGCACTGTTCCCACCTCCGCACCTCCGC
CACCTCCGCTAGAAAGGGGCCCGCACTGTT|GAAAGGGGCCCGCACTGTTCCCACCTCCGC
CGTAGCCTCTTCGAACCTCCGCTAGAAAGG|GCGTGGTTGGTAGCTTGTAGCTCCTAGCTT
CTACTGGCTGAGTTTCCTGGCGACGAGTCC|GCTAGAAAGGGGCCCGCACTGTTCTAGGAT
CTTCCCACCAGGCGCCGAAAGTATTTCGTT|CTACCTCCGCTAGAAAGGGGCCCGCACTGT
GTTCATCGCTAACGAGCCCATGCCCCCTAT|CCGCTAGAAAGGGGCCCGCACTGTTCTAGA
AGTACAACCGACTTCGGCCCCATCTCCCGT|GGGTCTAAGGCGATGTGTTCAGGCCCCGGC
CTGCTGCATGCATATAGCAAACCCTGGGTG|GGGAAAATGTCGACAGTACAACCGACTTCG
AGAAGTTTAAATGCATTCACGTGGTTTAAA|AGAAAGGGGCCCGCACTGTTCGCGCTGCAC
AGCCTCTTCGAACCTCCGCTAGAAAGGGGC|TGGTTGGTAGCTTGTAGCTCCTAGCTTCCC
GCTAGAAAGGGGCCCGCACTGTTCCCACCT|TAGCCCATGTGCTTAACGATAGCTGCCGGA
GGCTAGCGTGGTTGGTAGCTTGTAGCTCCT|TCGTCCCAACCTGGAGATTAGGCTGACCTC
CGCTAGAAAGGGGCCCGCACTGTTCGCATG|TGCTGCATGCATATAGCAAACCCTGGGTGA
CTTATTAGCTGATCACGTGACCCACCTGCT|ATTCCACAAAGATCCTTCCAGTCCGGGGAA
AGAAAGGGGCCCGCACTGTTCAAGGGGCCC|CGCATCAGGCGCGGAACGTTCGACGGACTA
CCCGTGAGGATGGACACAAAACGAGATTGA|CCGGCTCGGGGGCGCTGTGGGAATGATCAT
CCGCACTGTTCAGTTAATCTCGGGGTAGCC|TACATTAAGATTGCCACACCTCCGCTAGAA
CACTGTTCAGTTAATCTCGGGGTAGCCCAT|ATTAAGATTGCCACACCTCCGCTAGAAAGG
TCAGTTAATCTCGGGGTAGCCCATGTGCTT|ATTGCCACACCTCCGCTAGAAAGGGGCCCG
AGAAAGGGGCCCGCACTGTTCGGTGCGAAC|AGGGGCCCGCACCTCCGCTAGAAAGGGGCC
TAGGGACGTGGGGCTTTCCCCGTTGGGCAT|CGTCCAGTCGTAACGGTCACTATAGCAAAC
GAACAACACTCGTAGCGTTCGTCAGGTGGA|AACGAGCCCATGCCCCCTATTTCTACCGTA
CCAGGCGCCGAAAGTATTTCGTTATACGTA|CGCTAGAAAGGGGCCCGCACTGTTCAGAAA
ACCACGTCGCGTTGATGCCTCTGACCTCCG|CATCCAATGATTTCAGGTAACGAACATGCT
TCTAGAACCTCCGCTAGAAAGGGGCCCGCA|CGGCGCCTGACGTTACGCATCAGGCGCGGA
ATAGATCTACTGGCTGAGTTTCCTGGCGAC|ACCTCCGCTAGAAAGGGGCCCGCACTGTTC
CCGTTTCTGTAGAGATGCCGAGGAAAACAA|GTAGTGAGTCTTCCGTGTAGAACAACACTC
GAGCCCATGCCCCCTATTTCTACCGTACGG|GCCCGCACTGTTCTAGAACCTCCGCTAGAA
CACTGTTCTAGGATAAGGAATTCCACAAAG|CCGCTAGAAAGGGGCCCGCACTGTTCTTCG
ATGCGGATGGCGAAGCGCGCAACGAGTATG|AGGGGCCCGCACTGTTCGGTGCGAACTTAC
CGACGGACTACATTAAGATTGCCACACCTC|TAGGGACGTGGGGCTTTCCCCGTTGGGCAT
TTCAAGGGGCCCGCACTGTTCAGTTAATCT|TTCGACGGACTACATTAAGATTGCCACACC
CTAGAAAGGGGCCCGCACTGTTCAAGGGGC|TACGCATCAGGCGCGGAACGTTCGACGGAC
CGATAGCTGCCGGAGAAGTTTAAATGCATT|CTGTTCCTCCGCTAGAAAGGGGCCCGCACT
GCACTGTTCGGTGCGAACTTACGTAGTGAG|CTCCGCTAGAAAGGGGCCCGCACTGTTCAC
CACTGTTCCTCCGCTAGAAAGGGGCCCGCA|TTCCTGGCGACGAGTCCTTGTCCTTATTAG
GGTAACGAACATGCTACAACACCTCCGCTA|CCCGCACTGTTCAGTTAATCTCGGGGTAGC
ATAACTTACGGGCCTCGTGTAATACAAGTT|CGTGCTACATTCGTCGTACGCATACTGCTC
AACGAACATGCTACAACACCTCCGCTAGAA|GCACTGTTCAGTTAATCTCGGGGTAGCCCA
GGCCCGCACTGTTCTAGAACCTCCGCTAGA|TGGTTTAAATCCCGGCGCCTGACGTTACGC
GCCCGCACTGTTCTAGAACCTCCGCTAGAA|GGTTTAAATCCCGGCGCCTGACGTTACGCA
TGGTTTAAATCCCGGCGCCTGACGTTACGC|GCGCTGCACCTCCGCTAGAAAGGGGCCCGC
CGCACTGTTCGCATGTTTACTAGGGACGTG|GCAAACCCTGGGTGATAGCCCGTCCAGTCG
CTAGAAAGGGGCCCGCACTGTTCGCATGTT|CTGCATGCATATAGCAAACCCTGGGTGATA
TTCTACCGTACGGTACGCTTACATCCAATG|ACCTCCGCTAGAAAGGGGCCCGCACTGTTC
TTCCCTCCGCTAGAAAGGGGCCCGCACTGT|CCGAAAGTATTTCGTTATACGTATGCGGAT
CCTGGTATAACTTACGGGCCTCGTGTAATA|GTTCGTCGTGCTACATTCGTCGTACGCATA
GCCTCTGACCTCCGCTAGAAAGGGGCCCGC|GTAACGAACATGCTACAACACCTCCGCTAG
TCCGGGGAAAATGTCGACAGTACAACCGAC|CAACTTCATATTTCGCTGGGGTCTAAGGCG
GCCCGCACTGTTCTAGGATAAGGAATTCCA|GACCTCCGCTAGAAAGGGGCCCGCACTGTT
GGGCCCGCACTGTTCGTCGTGCTACATTCG|TACGTATGCGGATGGCGAAGCGCGCAACGA
CGCGCTGCACCTCCGCTAGAAAGGGGCCCG|CACGTGACCCACCTGCTGCATGCATATAGC
ACGTGGGGCTTTCCCCGTTGGGCATAGATC|AGTCGTAACGGTCACTATAGCAAACCTCCG
TGGAGAGCCAATGCGACCACGTCGCGTTGA|CGTACGGTACGCTTACATCCAATGATTTCA
CGGAGAAGTTTAAATGCATTCACGTGGTTT|GCTAGAAAGGGGCCCGCACTGTTCGCGCTG
CCGCTAGAAAGGGGCCCGCACTGTTCTAGG|ACCGGAAGCCTCGGACCTCCGCTAGAAAGG
GCGAACTTACGTAGTGAGTCTTCCGTGTAG|GGGGCCCGCACTGTTCACTGTTCATCGCTA
CGCTAGAAAGGGGCCCGCACTGTTCCCTCC|GCTCCTAGCTTCCCACCAGGCGCCGAAAGT
CACCAGGCGCCGAAAGTATTTCGTTATACG|TCCGCTAGAAAGGGGCCCGCACTGTTCAGA
CTTACGTAGTGAGTCTTCCGTGTAGAACAA|CCGCACTGTTCACTGTTCATCGCTAACGAG
GCCGTTTCTGTAGAGATGCCGAGGAAAACA|CGTAGTGAGTCTTCCGTGTAGAACAACACT
AGGGGCCCGCACTGTTCGCATGTTTACTAG|GCATATAGCAAACCCTGGGTGATAGCCCGT
AGCTGCCGGAGAAGTTTAAATGCATTCACG|TCCTCCGCTAGAAAGGGGCCCGCACTGTTC
GCCGGAGAAGTTTAAATGCATTCACGTGGT|CCGCTAGAAAGGGGCCCGCACTGTTCGCGC
CCGCTAGAAAGGGGCCCGCACCTCCGCTAG|GCTACAACACCTCCGCTAGAAAGGGGCCCG
CGGGGTAGCCCATGTGCTTAACGATAGCTG|TCCGCTAGAAAGGGGCCCGCACTGTTCCTC
GCCCGCACTGTTCAAGGGGCCCGCACTGTT|GCGCGGAACGTTCGACGGACTACATTAAGA
GAGATGCCGAGGAAAACAAGTTCGTCCCAA|TCCGTGTAGAACAACACTCGTAGCGTTCGT
TGTTCCCTCCGCTAGAAAGGGGCCCGCACT|CGCCGAAAGTATTTCGTTATACGTATGCGG
TAACGATAGCTGCCGGAGAAGTTTAAATGC|GCACTGTTCCTCCGCTAGAAAGGGGCCCGC
CTAGAAAGGGGCCCGCACTGTTCCCTCCGC|TCCTAGCTTCCCACCAGGCGCCGAAAGTAT
GGCTTTCCCCGTTGGGCATAGATCTACTGG|AACGGTCACTATAGCAAACCTCCGCTAGAA
GCTACCTCCGCTAGAAAGGGGCCCGCACTG|ACGTCGCGTTGATGCCTCTGACCTCCGCTA
CTAACGAGCCCATGCCCCCTATTTCTACCG|AAGGGGCCCGCACTGTTCTAGAACCTCCGC
ATAGCAAACCTCCGCTAGAAAGGGGCCCGC|AAACGAGATTGACCGGAAGCCTCGGACCTC
TAGCTGCCGGAGAAGTTTAAATGCATTCAC|TTCCTCCGCTAGAAAGGGGCCCGCACTGTT
CCCGCACTGTTCGGTGCGAACTTACGTAGT|CACCTCCGCTAGAAAGGGGCCCGCACTGTT
AGTTCGTCCCAACCTGGAGATTAGGCTGAC|CGTAGCGTTCGTCAGGTGGAGAGCCAATGC
CTGTTCCCTCCGCTAGAAAGGGGCCCGCAC|GCGCCGAAAGTATTTCGTTATACGTATGCG
GGGCCCGCACTGTTCGCGCTGCACCTCCGC|CCTTATTAGCTGATCACGTGACCCACCTGC
GATTAGGCTGACCTCCGCTACCTCCGCTAG|GAGAGCCAATGCGACCACGTCGCGTTGATG
TGGCTGAGTTTCCTGGCGACGAGTCCTTGT|GAAAGGGGCCCGCACTGTTCTAGGATAAGG
GCTAGAAAGGGGCCCGCACTGTTCGTCGTG|ATTTCGTTATACGTATGCGGATGGCGAAGC
ACCTCCGCTAGAAAGGGGCCCGCACTGTTC|ATTGACCGGAAGCCTCGGACCTCCGCTAGA
ATGCATTCACGTGGTTTAAATCCCGGCGCC|CCGCACTGTTCGCGCTGCACCTCCGCTAGA
GCATAGATCTACTGGCTGAGTTTCCTGGCG|AAACCTCCGCTAGAAAGGGGCCCGCACTGT
GGGCTTACCTCGTTCCCGGCTAGCGTGGTT|TGCCGAGGAAAACAAGTTCGTCCCAACCTG
GTAGAGATGCCGAGGAAAACAAGTTCGTCC|TCTTCCGTGTAGAACAACACTCGTAGCGTT
GGAATTCCACAAAGATCCTTCCAGTCCGGG|CGCACTGTTCTTCGCTCCGCAGGTCAACTT
CCTTCCAGTCCGGGGAAAATGTCGACAGTA|CCGCAGGTCAACTTCATATTTCGCTGGGGT
ATGGCGAAGCGCGCAACGAGTATGCCGTTT|CCGCACTGTTCGGTGCGAACTTACGTAGTG
GTGCTTAACGATAGCTGCCGGAGAAGTTTA|GGCCCGCACTGTTCCTCCGCTAGAAAGGGG
ACTATAGCAAACCTCCGCTAGAAAGGGGCC|ACAAAACGAGATTGACCGGAAGCCTCGGAC
TACACGTATCTGGTGTTCCGCGTAGCCTCT|GCTTACCTCGTTCCCGGCTAGCGTGGTTGG
GTTCAGAAAGGGGCCCGCACTGTTCGGTGC|AGAAAGGGGCCCGCACCTCCGCTAGAAAGG
CCCAACCTGGAGATTAGGCTGACCTCCGCT|TTCGTCAGGTGGAGAGCCAATGCGACCACG
TCTGACCTCCGCTAGAAAGGGGCCCGCACC|ACGAACATGCTACAACACCTCCGCTAGAAA
TCCTTATTAGCTGATCACGTGACCCACCTG|GAATTCCACAAAGATCCTTCCAGTCCGGGG
GTGGTTTAAATCCCGGCGCCTGACGTTACG|CGCGCTGCACCTCCGCTAGAAAGGGGCCCG
AAGGGGCCCGCACTGTTCGCGCTGCACCTC|TGTCCTTATTAGCTGATCACGTGACCCACC
AAAGTATTTCGTTATACGTATGCGGATGGC|GGGCCCGCACTGTTCAGAAAGGGGCCCGCA
GCATGTTTACTAGGGACGTGGGGCTTTCCC|GGTGATAGCCCGTCCAGTCGTAACGGTCAC
CGGAACGTTCGACGGACTACATTAAGATTG|CATGTTTACTAGGGACGTGGGGCTTTCCCC
CGTACGGTACGCTTACATCCAATGATTTCA|GCTAGAAAGGGGCCCGCACTGTTCAAGGGG
TTCGTCGTACGCATACTGCTCGTCGGGCTT|ACGAGTATGCCGTTTCTGTAGAGATGCCGA
GCCGAAAGTATTTCGTTATACGTATGCGGA|AAAGGGGCCCGCACTGTTCAGAAAGGGGCC
TGCCGTTTCTGTAGAGATGCCGAGGAAAAC|ACGTAGTGAGTCTTCCGTGTAGAACAACAC
GGGCCCGCACTGTTCCTCCGCTAGAAAGGG|GCTGAGTTTCCTGGCGACGAGTCCTTGTCC
CCGCTAGAAAGGGGCCCGCACTGTTCGCGC|CGAGTCCTTGTCCTTATTAGCTGATCACGT
CGCTTACATCCAATGATTTCAGGTAACGAA|GGGCCCGCACTGTTCAAGGGGCCCGCACTG
GTCAGGTGGAGAGCCAATGCGACCACGTCG|TTCTACCGTACGGTACGCTTACATCCAATG
AGGGGCCCGCACCTCCGCTAGAAAGGGGCC|CCTCCGCTAGAAAGGGGCCCGCACTGTTCC
ATGCCTCTGACCTCCGCTAGAAAGGGGCCC|AGGTAACGAACATGCTACAACACCTCCGCT
GTACGCTTACATCCAATGATTTCAGGTAAC|AAGGGGCCCGCACTGTTCAAGGGGCCCGCA
TGTAGAGATGCCGAGGAAAACAAGTTCGTC|GTCTTCCGTGTAGAACAACACTCGTAGCGT
AGAAAGGGGCCCGCACTGTTCAGAAAGGGG|TGCCTCTGACCTCCGCTAGAAAGGGGCCCG
TCCCAACCTGGAGATTAGGCTGACCTCCGC|GTTCGTCAGGTGGAGAGCCAATGCGACCAC
GTTGATGCCTCTGACCTCCGCTAGAAAGGG|TTTCAGGTAACGAACATGCTACAACACCTC
GTGAGTCTTCCGTGTAGAACAACACTCGTA|TTCACTGTTCATCGCTAACGAGCCCATGCC
CCGCTAGAAAGGGGCCCGCACTGTTCCCAC|GGTAGCCCATGTGCTTAACGATAGCTGCCG
TACATTCGTCGTACGCATACTGCTCGTCGG|CGCAACGAGTATGCCGTTTCTGTAGAGATG
TTAACGATAGCTGCCGGAGAAGTTTAAATG|CGCACTGTTCCTCCGCTAGAAAGGGGCCCG
GGCCCGCACTGTTCAAGGGGCCCGCACTGT|GGCGCGGAACGTTCGACGGACTACATTAAG
AGGTAACGAACATGCTACAACACCTCCGCT|GCCCGCACTGTTCAGTTAATCTCGGGGTAG
CCGCACTGTTCACTGTTCATCGCTAACGAG|CCACCTCCGCACCTCCGCTAGAAAGGGGCC
CCCGGCTAGCGTGGTTGGTAGCTTGTAGCT|AGTTCGTCCCAACCTGGAGATTAGGCTGAC
CGCTAGAAAGGGGCCCGCACCTCCGCTAGA|CTACAACACCTCCGCTAGAAAGGGGCCCGC
TCCCGGCGCCTGACGTTACGCATCAGGCGC|CTCCGCTAGAAAGGGGCCCGCACTGTTCGC
CGGGCCTCGTGTAATACAAGTTGAGGGTAC|ATTCGTCGTACGCATACTGCTCGTCGGGCT
CATCAGGCGCGGAACGTTCGACGGACTACA|CACTGTTCGCATGTTTACTAGGGACGTGGG
CGCTGCACCTCCGCTAGAAAGGGGCCCGCA|CGTGACCCACCTGCTGCATGCATATAGCAA
AACGAGCCCATGCCCCCTATTTCTACCGTA|GGGGCCCGCACTGTTCTAGAACCTCCGCTA
GAAAGGGGCCCGCACTGTTCTAGGATAAGG|AGCCTCGGACCTCCGCTAGAAAGGGGCCCG
AGATCCTTCCAGTCCGGGGAAAATGTCGAC|CGCTCCGCAGGTCAACTTCATATTTCGCTG
TCCGCTACCTCCGCTAGAAAGGGGCCCGCA|ACCACGTCGCGTTGATGCCTCTGACCTCCG
GGGCCCGCACTGTTCAGAAAGGGGCCCGCA|TGACCTCCGCTAGAAAGGGGCCCGCACCTC
TCGGTGCGAACTTACGTAGTGAGTCTTCCG|AGAAAGGGGCCCGCACTGTTCACTGTTCAT
TGTTCCCACCTCCGCACCTCCGCTAGAAAG|TAGCTGCCGGAGAAGTTTAAATGCATTCAC
TACGTATGCGGATGGCGAAGCGCGCAACGA|CAGAAAGGGGCCCGCACTGTTCGGTGCGAA
TATAGCAAACCTCCGCTAGAAAGGGGCCCG|AAAACGAGATTGACCGGAAGCCTCGGACCT
CAGGTGGAGAGCCAATGCGACCACGTCGCG|CTACCGTACGGTACGCTTACATCCAATGAT
TAGCTGATCACGTGACCCACCTGCTGCATG|ACAAAGATCCTTCCAGTCCGGGGAAAATGT
CTAGAAAGGGGCCCGCACTGTTCTAGGATA|GGAAGCCTCGGACCTCCGCTAGAAAGGGGC
TATTAGCTGATCACGTGACCCACCTGCTGC|TCCACAAAGATCCTTCCAGTCCGGGGAAAA
TATGCGGATGGCGAAGCGCGCAACGAGTAT|AAGGGGCCCGCACTGTTCGGTGCGAACTTA
GCTGATCACGTGACCCACCTGCTGCATGCA|AAAGATCCTTCCAGTCCGGGGAAAATGTCG
TACCTCCGCTAGAAAGGGGCCCGCACTGTT|GTCGCGTTGATGCCTCTGACCTCCGCTAGA
GTTGGTAGCTTGTAGCTCCTAGCTTCCCAC|CTGGAGATTAGGCTGACCTCCGCTACCTCC
ACCTCCGCACCTCCGCTAGAAAGGGGCCCG|CGGAGAAGTTTAAATGCATTCACGTGGTTT
TCTCGGGGTAGCCCATGTGCTTAACGATAG|ACCTCCGCTAGAAAGGGGCCCGCACTGTTC
TTCGTCAGGTGGAGAGCCAATGCGACCACG|TATTTCTACCGTACGGTACGCTTACATCCA
CTCTTCGAACCTCCGCTAGAAAGGGGCCCG|TTGGTAGCTTGTAGCTCCTAGCTTCCCACC
AACGATAGCTGCCGGAGAAGTTTAAATGCA|CACTGTTCCTCCGCTAGAAAGGGGCCCGCA
TGAGTCTTCCGTGTAGAACAACACTCGTAG|TCACTGTTCATCGCTAACGAGCCCATGCCC
AAAGGGGCCCGCACTGTTCGGTGCGAACTT|GGGCCCGCACCTCCGCTAGAAAGGGGCCCG
CTGAGTTTCCTGGCGACGAGTCCTTGTCCT|AGGGGCCCGCACTGTTCTAGGATAAGGAAT
AGCCCATGCCCCCTATTTCTACCGTACGGT|CCCGCACTGTTCTAGAACCTCCGCTAGAAA
TGTTCGTCGTGCTACATTCGTCGTACGCAT|GATGGCGAAGCGCGCAACGAGTATGCCGTT
TCCGTGTAGAACAACACTCGTAGCGTTCGT|TCATCGCTAACGAGCCCATGCCCCCTATTT
TTCGTTATACGTATGCGGATGGCGAAGCGC|CACTGTTCAGAAAGGGGCCCGCACTGTTCG
CCATCTCCCGTGAGGATGGACACAAAACGA|CAGGCCCCGGCTCGGGGGCGCTGTGGGAAT
GATAAGGAATTCCACAAAGATCCTTCCAGT|GGGCCCGCACTGTTCTTCGCTCCGCAGGTC
TCCGCTAGAAAGGGGCCCGCACTGTTCGTC|AGTATTTCGTTATACGTATGCGGATGGCGA
TCAGGCGCGGAACGTTCGACGGACTACATT|CTGTTCGCATGTTTACTAGGGACGTGGGGC
GGAAAATGTCGACAGTACAACCGACTTCGG|TCATATTTCGCTGGGGTCTAAGGCGATGTG
CCCTGGGTGATAGCCCGTCCAGTCGTAACG|CCGACTTCGGCCCCATCTCCCGTGAGGATG
TCCAGTCCGGGGAAAATGTCGACAGTACAA|CAGGTCAACTTCATATTTCGCTGGGGTCTA
CTGTTCAGTTAATCTCGGGGTAGCCCATGT|TAAGATTGCCACACCTCCGCTAGAAAGGGG
CACTGTTCATCGCTAACGAGCCCATGCCCC|ACCTCCGCTAGAAAGGGGCCCGCACTGTTC
ACGATAGCTGCCGGAGAAGTTTAAATGCAT|ACTGTTCCTCCGCTAGAAAGGGGCCCGCAC
TTCCTGGCGACGAGTCCTTGTCCTTATTAG|CCGCACTGTTCTAGGATAAGGAATTCCACA
CGTGCTACATTCGTCGTACGCATACTGCTC|AAGCGCGCAACGAGTATGCCGTTTCTGTAG
GCTCCTAGCTTCCCACCAGGCGCCGAAAGT|GACCTCCGCTACCTCCGCTAGAAAGGGGCC
CGGCGCCTGACGTTACGCATCAGGCGCGGA|CGCTAGAAAGGGGCCCGCACTGTTCGCATG
CTGGTATAACTTACGGGCCTCGTGTAATAC|TTCGTCGTGCTACATTCGTCGTACGCATAC
CCCGCACTGTTCCCACCTCCGCACCTCCGC|TTAACGATAGCTGCCGGAGAAGTTTAAATG
AGGCGCGGAACGTTCGACGGACTACATTAA|GTTCGCATGTTTACTAGGGACGTGGGGCTT
AGAACAACACTCGTAGCGTTCGTCAGGTGG|TAACGAGCCCATGCCCCCTATTTCTACCGT
TTCGTCGTGCTACATTCGTCGTACGCATAC|TGGCGAAGCGCGCAACGAGTATGCCGTTTC
TGGGGCTTTCCCCGTTGGGCATAGATCTAC|CGTAACGGTCACTATAGCAAACCTCCGCTA
GTAGCGTTCGTCAGGTGGAGAGCCAATGCG|GCCCCCTATTTCTACCGTACGGTACGCTTA
ACTGTTCCCTCCGCTAGAAAGGGGCCCGCA|GGCGCCGAAAGTATTTCGTTATACGTATGC
AAGGGGCCCGCACTGTTCCCTCCGCTAGAA|GCTTCCCACCAGGCGCCGAAAGTATTTCGT
CTCGTAGCGTTCGTCAGGTGGAGAGCCAAT|CATGCCCCCTATTTCTACCGTACGGTACGC
TCCGCGTAGCCTCTTCGAACCTCCGCTAGA|GCTAGCGTGGTTGGTAGCTTGTAGCTCCTA
GACAGTACAACCGACTTCGGCCCCATCTCC|CTGGGGTCTAAGGCGATGTGTTCAGGCCCC
CACCTCCGCACCTCCGCTAGAAAGGGGCCC|CCGGAGAAGTTTAAATGCATTCACGTGGTT
TAGAAAGGGGCCCGCACTGTTCGTCGTGCT|TTCGTTATACGTATGCGGATGGCGAAGCGC
CGAGTCCTTGTCCTTATTAGCTGATCACGT|CTAGGATAAGGAATTCCACAAAGATCCTTC
GGCGAAGCGCGCAACGAGTATGCCGTTTCT|GCACTGTTCGGTGCGAACTTACGTAGTGAG
CGTTGGGCATAGATCTACTGGCTGAGTTTC|TATAGCAAACCTCCGCTAGAAAGGGGCCCG
GTATGCCGTTTCTGTAGAGATGCCGAGGAA|CTTACGTAGTGAGTCTTCCGTGTAGAACAA
TCGTCGGGCTTACCTCGTTCCCGGCTAGCG|AGAGATGCCGAGGAAAACAAGTTCGTCCCA
ATTTCTACCGTACGGTACGCTTACATCCAA|GAACCTCCGCTAGAAAGGGGCCCGCACTGT
CTTCCGTGTAGAACAACACTCGTAGCGTTC|GTTCATCGCTAACGAGCCCATGCCCCCTAT
CATGCCCCCTATTTCTACCGTACGGTACGC|CACTGTTCTAGAACCTCCGCTAGAAAGGGG
CCGCACCTCCGCTAGAAAGGGGCCCGCACT|GAAGTTTAAATGCATTCACGTGGTTTAAAT
CCTTGTCCTTATTAGCTGATCACGTGACCC|ATAAGGAATTCCACAAAGATCCTTCCAGTC
TCGTAACGGTCACTATAGCAAACCTCCGCT|TGAGGATGGACACAAAACGAGATTGACCGG
GCCCGCACTGTTCCCTCCGCTAGAAAGGGG|CCACCAGGCGCCGAAAGTATTTCGTTATAC
ACTGTTCGTCGTGCTACATTCGTCGTACGC|CGGATGGCGAAGCGCGCAACGAGTATGCCG
CTCCGCTACCTCCGCTAGAAAGGGGCCCGC|GACCACGTCGCGTTGATGCCTCTGACCTCC
GCAAACCTCCGCTAGAAAGGGGCCCGCACT|CGAGATTGACCGGAAGCCTCGGACCTCCGC
TACAACCGACTTCGGCCCCATCTCCCGTGA|GTCTAAGGCGATGTGTTCAGGCCCCGGCTC
CCTTATTAGCTGATCACGTGACCCACCTGC|AATTCCACAAAGATCCTTCCAGTCCGGGGA
GTGACCCACCTGCTGCATGCATATAGCAAA|TCCAGTCCGGGGAAAATGTCGACAGTACAA
GTTCTAGAACCTCCGCTAGAAAGGGGCCCG|CCCGGCGCCTGACGTTACGCATCAGGCGCG
GCTGCCGGAGAAGTTTAAATGCATTCACGT|CCTCCGCTAGAAAGGGGCCCGCACTGTTCG
TTGGTAGCTTGTAGCTCCTAGCTTCCCACC|TGGAGATTAGGCTGACCTCCGCTACCTCCG
CCGCTAGAAAGGGGCCCGCACTGTTCCTCC|TAGATCTACTGGCTGAGTTTCCTGGCGACG
GGGGCCCGCACTGTTCGCATGTTTACTAGG|CATATAGCAAACCCTGGGTGATAGCCCGTC
AAAGGGGCCCGCACTGTTCGCGCTGCACCT|TTGTCCTTATTAGCTGATCACGTGACCCAC
CTGTTCGTCGTGCTACATTCGTCGTACGCA|GGATGGCGAAGCGCGCAACGAGTATGCCGT
CACGTGGTTTAAATCCCGGCGCCTGACGTT|GTTCGCGCTGCACCTCCGCTAGAAAGGGGC
TAGAACCTCCGCTAGAAAGGGGCCCGCACT|GCGCCTGACGTTACGCATCAGGCGCGGAAC
CTGGGTGATAGCCCGTCCAGTCGTAACGGT|GACTTCGGCCCCATCTCCCGTGAGGATGGA
TGTGCTTAACGATAGCTGCCGGAGAAGTTT|GGGCCCGCACTGTTCCTCCGCTAGAAAGGG
ATATAGCAAACCCTGGGTGATAGCCCGTCC|GACAGTACAACCGACTTCGGCCCCATCTCC
CCGGCTAGCGTGGTTGGTAGCTTGTAGCTC|GTTCGTCCCAACCTGGAGATTAGGCTGACC
TCGCGCTGCACCTCCGCTAGAAAGGGGCCC|TCACGTGACCCACCTGCTGCATGCATATAG
TGCCGAGGAAAACAAGTTCGTCCCAACCTG|TGTAGAACAACACTCGTAGCGTTCGTCAGG
CGTAACGGTCACTATAGCAAACCTCCGCTA|GAGGATGGACACAAAACGAGATTGACCGGA
ATTCCACAAAGATCCTTCCAGTCCGGGGAA|ACTGTTCTTCGCTCCGCAGGTCAACTTCAT
CTAGAACCTCCGCTAGAAAGGGGCCCGCAC|GGCGCCTGACGTTACGCATCAGGCGCGGAA
CCGCACTGTTCTAGGATAAGGAATTCCACA|CCTCCGCTAGAAAGGGGCCCGCACTGTTCT
GGTACACGTATCTGGTGTTCCGCGTAGCCT|GGGCTTACCTCGTTCCCGGCTAGCGTGGTT
TCCGCTAGAAAGGGGCCCGCACCTCCGCTA|TGCTACAACACCTCCGCTAGAAAGGGGCCC
CCATGCCCCCTATTTCTACCGTACGGTACG|GCACTGTTCTAGAACCTCCGCTAGAAAGGG
GTGATAGCCCGTCCAGTCGTAACGGTCACT|TCGGCCCCATCTCCCGTGAGGATGGACACA
CGCTAGAAAGGGGCCCGCACTGTTCTAGGA|CCGGAAGCCTCGGACCTCCGCTAGAAAGGG
CGTCGCGTTGATGCCTCTGACCTCCGCTAG|CAATGATTTCAGGTAACGAACATGCTACAA
TAAGGAATTCCACAAAGATCCTTCCAGTCC|GCCCGCACTGTTCTTCGCTCCGCAGGTCAA
CTTCGAACCTCCGCTAGAAAGGGGCCCGCA|GGTAGCTTGTAGCTCCTAGCTTCCCACCAG
CCGACTTCGGCCCCATCTCCCGTGAGGATG|AGGCGATGTGTTCAGGCCCCGGCTCGGGGG
AACACTCGTAGCGTTCGTCAGGTGGAGAGC|AGCCCATGCCCCCTATTTCTACCGTACGGT
GTTGAGGGTACACGTATCTGGTGTTCCGCG|CTCGTCGGGCTTACCTCGTTCCCGGCTAGC
CCGCACTGTTCAAGGGGCCCGCACTGTTCA|GCGGAACGTTCGACGGACTACATTAAGATT
GGGGCCCGCACTGTTCACTGTTCATCGCTA|TGTTCCCACCTCCGCACCTCCGCTAGAAAG
CCGGCGCCTGACGTTACGCATCAGGCGCGG|CCGCTAGAAAGGGGCCCGCACTGTTCGCAT
TCCCGTGAGGATGGACACAAAACGAGATTG|CCCGGCTCGGGGGCGCTGTGGGAATGATCA
ACGGGCCTCGTGTAATACAAGTTGAGGGTA|CATTCGTCGTACGCATACTGCTCGTCGGGC
CGCTAACGAGCCCATGCCCCCTATTTCTAC|GAAAGGGGCCCGCACTGTTCTAGAACCTCC
CGAACTTACGTAGTGAGTCTTCCGTGTAGA|GGGCCCGCACTGTTCACTGTTCATCGCTAA
CCCGCACTGTTCAGAAAGGGGCCCGCACTG|CCTCCGCTAGAAAGGGGCCCGCACCTCCGC
CCTCCGCTAGAAAGGGGCCCGCACTGTTCA|AAGGGGCCCGCACTGTTCCCACCTCCGCAC
GTATGCGGATGGCGAAGCGCGCAACGAGTA|AAAGGGGCCCGCACTGTTCGGTGCGAACTT
AGTCCTTGTCCTTATTAGCTGATCACGTGA|AGGATAAGGAATTCCACAAAGATCCTTCCA
TTCACGTGGTTTAAATCCCGGCGCCTGACG|CTGTTCGCGCTGCACCTCCGCTAGAAAGGG
AAGGGGCCCGCACTGTTCGCATGTTTACTA|TGCATATAGCAAACCCTGGGTGATAGCCCG
TCCGCTAGAAAGGGGCCCGCACTGTTCCCT|TAGCTCCTAGCTTCCCACCAGGCGCCGAAA
GTACGCATACTGCTCGTCGGGCTTACCTCG|ATGCCGTTTCTGTAGAGATGCCGAGGAAAA
CATCTCCCGTGAGGATGGACACAAAACGAG|AGGCCCCGGCTCGGGGGCGCTGTGGGAATG
AGCTCCTAGCTTCCCACCAGGCGCCGAAAG|TGACCTCCGCTACCTCCGCTAGAAAGGGGC
GCCACACCTCCGCTAGAAAGGGGCCCGCAC|CGTTGGGCATAGATCTACTGGCTGAGTTTC
GGAGATTAGGCTGACCTCCGCTACCTCCGC|GTGGAGAGCCAATGCGACCACGTCGCGTTG
TCACTATAGCAAACCTCCGCTAGAAAGGGG|ACACAAAACGAGATTGACCGGAAGCCTCGG
ACGGTACGCTTACATCCAATGATTTCAGGT|AGAAAGGGGCCCGCACTGTTCAAGGGGCCC
GGGAAAATGTCGACAGTACAACCGACTTCG|TTCATATTTCGCTGGGGTCTAAGGCGATGT
CGCCGAAAGTATTTCGTTATACGTATGCGG|GAAAGGGGCCCGCACTGTTCAGAAAGGGGC
CCAATGATTTCAGGTAACGAACATGCTACA|CTGTTCAAGGGGCCCGCACTGTTCAGTTAA
TAAATCCCGGCGCCTGACGTTACGCATCAG|GCACCTCCGCTAGAAAGGGGCCCGCACTGT
ACGTTCGACGGACTACATTAAGATTGCCAC|TTTACTAGGGACGTGGGGCTTTCCCCGTTG
GTTATACGTATGCGGATGGCGAAGCGCGCA|TGTTCAGAAAGGGGCCCGCACTGTTCGGTG
CGTGGTTTAAATCCCGGCGCCTGACGTTAC|TCGCGCTGCACCTCCGCTAGAAAGGGGCCC
TGCATATAGCAAACCCTGGGTGATAGCCCG|GTCGACAGTACAACCGACTTCGGCCCCATC
CCACCTCCGCACCTCCGCTAGAAAGGGGCC|GCCGGAGAAGTTTAAATGCATTCACGTGGT
CGACCACGTCGCGTTGATGCCTCTGACCTC|TACATCCAATGATTTCAGGTAACGAACATG
TTCTGTAGAGATGCCGAGGAAAACAAGTTC|TGAGTCTTCCGTGTAGAACAACACTCGTAG
CGTGAGGATGGACACAAAACGAGATTGACC|GGCTCGGGGGCGCTGTGGGAATGATCATAG
AAGGAATTCCACAAAGATCCTTCCAGTCCG|CCCGCACTGTTCTTCGCTCCGCAGGTCAAC
AATGCATTCACGTGGTTTAAATCCCGGCGC|CCCGCACTGTTCGCGCTGCACCTCCGCTAG
TGTAGCTCCTAGCTTCCCACCAGGCGCCGA|GGCTGACCTCCGCTACCTCCGCTAGAAAGG
CGCAACGAGTATGCCGTTTCTGTAGAGATG|GGTGCGAACTTACGTAGTGAGTCTTCCGTG
TCGTCGTACGCATACTGCTCGTCGGGCTTA|CGAGTATGCCGTTTCTGTAGAGATGCCGAG
TGGTAGCTTGTAGCTCCTAGCTTCCCACCA|GGAGATTAGGCTGACCTCCGCTACCTCCGC
TACCGTACGGTACGCTTACATCCAATGATT|TCCGCTAGAAAGGGGCCCGCACTGTTCAAG
AGGGGCCCGCACTGTTCCTCCGCTAGAAAG|TGGCTGAGTTTCCTGGCGACGAGTCCTTGT
AGCCAATGCGACCACGTCGCGTTGATGCCT|GGTACGCTTACATCCAATGATTTCAGGTAA
AACCCTGGGTGATAGCCCGTCCAGTCGTAA|AACCGACTTCGGCCCCATCTCCCGTGAGGA
CGGTACGCTTACATCCAATGATTTCAGGTA|GAAAGGGGCCCGCACTGTTCAAGGGGCCCG
AGCGTTCGTCAGGTGGAGAGCCAATGCGAC|CCCCTATTTCTACCGTACGGTACGCTTACA
TGTTCTAGGATAAGGAATTCCACAAAGATC|CTAGAAAGGGGCCCGCACTGTTCTTCGCTC
TAGAAAGGGGCCCGCACTGTTCTAGAACCT|CATTCACGTGGTTTAAATCCCGGCGCCTGA
GAGGGTACACGTATCTGGTGTTCCGCGTAG|GTCGGGCTTACCTCGTTCCCGGCTAGCGTG
TGCATTCACGTGGTTTAAATCCCGGCGCCT|CGCACTGTTCGCGCTGCACCTCCGCTAGAA
TAGAAAGGGGCCCGCACTGTTCCCTCCGCT|CCTAGCTTCCCACCAGGCGCCGAAAGTATT
GAACCTCCGCTAGAAAGGGGCCCGCACTGT|GCCTGACGTTACGCATCAGGCGCGGAACGT
GCTAGAAAGGGGCCCGCACTGTTCAGAAAG|TGATGCCTCTGACCTCCGCTAGAAAGGGGC
AAGGGGCCCGCACCTCCGCTAGAAAGGGGC|ACCTCCGCTAGAAAGGGGCCCGCACTGTTC
CGTCCAGTCGTAACGGTCACTATAGCAAAC|TCTCCCGTGAGGATGGACACAAAACGAGAT
ACATGCTACAACACCTCCGCTAGAAAGGGG|GTTCAGTTAATCTCGGGGTAGCCCATGTGC
GAGGATGGACACAAAACGAGATTGACCGGA|TCGGGGGCGCTGTGGGAATGATCATAGTAG
GTCACTATAGCAAACCTCCGCTAGAAAGGG|GACACAAAACGAGATTGACCGGAAGCCTCG
TCCTGGCGACGAGTCCTTGTCCTTATTAGC|CGCACTGTTCTAGGATAAGGAATTCCACAA
TGCCTGGTATAACTTACGGGCCTCGTGTAA|CTGTTCGTCGTGCTACATTCGTCGTACGCA
GGTTTAAATCCCGGCGCCTGACGTTACGCA|CGCTGCACCTCCGCTAGAAAGGGGCCCGCA
GTTAGATAGTTGCCTGGTATAACTTACGGG|GGGGCCCGCACTGTTCGTCGTGCTACATTC
TGAGTTTCCTGGCGACGAGTCCTTGTCCTT|GGGGCCCGCACTGTTCTAGGATAAGGAATT
TAGCCCATGTGCTTAACGATAGCTGCCGGA|TAGAAAGGGGCCCGCACTGTTCCTCCGCTA
ACTGTTCCCACCTCCGCACCTCCGCTAGAA|GATAGCTGCCGGAGAAGTTTAAATGCATTC
AGGGGCCCGCACTGTTCCCTCCGCTAGAAA|CTTCCCACCAGGCGCCGAAAGTATTTCGTT
ATAGCCCGTCCAGTCGTAACGGTCACTATA|GCCCCATCTCCCGTGAGGATGGACACAAAA
TAGAACAACACTCGTAGCGTTCGTCAGGTG|CTAACGAGCCCATGCCCCCTATTTCTACCG
CCTCCGCTAGAAAGGGGCCCGCACTGTTCC|TGTAGCTCCTAGCTTCCCACCAGGCGCCGA
GATGGCGAAGCGCGCAACGAGTATGCCGTT|CCCGCACTGTTCGGTGCGAACTTACGTAGT
AGGGGCCCGCACTGTTCGCGCTGCACCTCC|GTCCTTATTAGCTGATCACGTGACCCACCT
CACCTCCGCTAGAAAGGGGCCCGCACTGTT|GGGCATAGATCTACTGGCTGAGTTTCCTGG
ACTGTTCCTCCGCTAGAAAGGGGCCCGCAC|TCCTGGCGACGAGTCCTTGTCCTTATTAGC
TCATCGCTAACGAGCCCATGCCCCCTATTT|GCTAGAAAGGGGCCCGCACTGTTCTAGAAC
TCACGTGGTTTAAATCCCGGCGCCTGACGT|TGTTCGCGCTGCACCTCCGCTAGAAAGGGG
GCTTCCCACCAGGCGCCGAAAGTATTTCGT|GCTACCTCCGCTAGAAAGGGGCCCGCACTG
GGGCTTTCCCCGTTGGGCATAGATCTACTG|TAACGGTCACTATAGCAAACCTCCGCTAGA
TATTTCGTTATACGTATGCGGATGGCGAAG|CCGCACTGTTCAGAAAGGGGCCCGCACTGT
GTACGGTACGCTTACATCCAATGATTTCAG|CTAGAAAGGGGCCCGCACTGTTCAAGGGGC
CGTCCCAACCTGGAGATTAGGCTGACCTCC|GCGTTCGTCAGGTGGAGAGCCAATGCGACC
GCCCGCACTGTTCCTCCGCTAGAAAGGGGC|TGAGTTTCCTGGCGACGAGTCCTTGTCCTT
TCCCCGTTGGGCATAGATCTACTGGCTGAG|TCACTATAGCAAACCTCCGCTAGAAAGGGG
TGCTACATTCGTCGTACGCATACTGCTCGT|GCGCGCAACGAGTATGCCGTTTCTGTAGAG
CGTATCTGGTGTTCCGCGTAGCCTCTTCGA|ACCTCGTTCCCGGCTAGCGTGGTTGGTAGC
TTTCAGGTAACGAACATGCTACAACACCTC|AGGGGCCCGCACTGTTCAGTTAATCTCGGG
CGCACTGTTCTAGGATAAGGAATTCCACAA|CTCCGCTAGAAAGGGGCCCGCACTGTTCTT
AAAGGGGCCCGCACTGTTCTAGAACCTCCG|TCACGTGGTTTAAATCCCGGCGCCTGACGT
TAGAGATGCCGAGGAAAACAAGTTCGTCCC|CTTCCGTGTAGAACAACACTCGTAGCGTTC
CGCACTGTTCGGTGCGAACTTACGTAGTGA|CCTCCGCTAGAAAGGGGCCCGCACTGTTCA
TTCCGCGTAGCCTCTTCGAACCTCCGCTAG|GGCTAGCGTGGTTGGTAGCTTGTAGCTCCT
CGACGAGTCCTTGTCCTTATTAGCTGATCA|GTTCTAGGATAAGGAATTCCACAAAGATCC
AATTCCACAAAGATCCTTCCAGTCCGGGGA|CACTGTTCTTCGCTCCGCAGGTCAACTTCA
CAGTCCGGGGAAAATGTCGACAGTACAACC|GGTCAACTTCATATTTCGCTGGGGTCTAAG
AGGCGCCGAAAGTATTTCGTTATACGTATG|CTAGAAAGGGGCCCGCACTGTTCAGAAAGG
CTGACCTCCGCTACCTCCGCTAGAAAGGGG|AATGCGACCACGTCGCGTTGATGCCTCTGA
CCACCAGGCGCCGAAAGTATTTCGTTATAC|CTCCGCTAGAAAGGGGCCCGCACTGTTCAG
GGTGTTCCGCGTAGCCTCTTCGAACCTCCG|TCCCGGCTAGCGTGGTTGGTAGCTTGTAGC
TTCGACGGACTACATTAAGATTGCCACACC|ACTAGGGACGTGGGGCTTTCCCCGTTGGGC
CTAGGATAAGGAATTCCACAAAGATCCTTC|AAAGGGGCCCGCACTGTTCTTCGCTCCGCA
GCTAGAAAGGGGCCCGCACTGTTCTAGAAC|TGCATTCACGTGGTTTAAATCCCGGCGCCT
GTCGTACGCATACTGCTCGTCGGGCTTACC|AGTATGCCGTTTCTGTAGAGATGCCGAGGA
GTAGCCCATGTGCTTAACGATAGCTGCCGG|CTAGAAAGGGGCCCGCACTGTTCCTCCGCT
CACTGTTCGCATGTTTACTAGGGACGTGGG|AAACCCTGGGTGATAGCCCGTCCAGTCGTA
TTCCCACCAGGCGCCGAAAGTATTTCGTTA|TACCTCCGCTAGAAAGGGGCCCGCACTGTT
CACTATAGCAAACCTCCGCTAGAAAGGGGC|CACAAAACGAGATTGACCGGAAGCCTCGGA
CGAGGAAAACAAGTTCGTCCCAACCTGGAG|AGAACAACACTCGTAGCGTTCGTCAGGTGG
GAGCCAATGCGACCACGTCGCGTTGATGCC|CGGTACGCTTACATCCAATGATTTCAGGTA
GGTAGCCCATGTGCTTAACGATAGCTGCCG|GCTAGAAAGGGGCCCGCACTGTTCCTCCGC
ACTGGCTGAGTTTCCTGGCGACGAGTCCTT|TAGAAAGGGGCCCGCACTGTTCTAGGATAA
ACCGACTTCGGCCCCATCTCCCGTGAGGAT|AAGGCGATGTGTTCAGGCCCCGGCTCGGGG
TCGACAGTACAACCGACTTCGGCCCCATCT|CGCTGGGGTCTAAGGCGATGTGTTCAGGCC
CACTCGTAGCGTTCGTCAGGTGGAGAGCCA|CCCATGCCCCCTATTTCTACCGTACGGTAC
CCTCCGCTAGAAAGGGGCCCGCACTGTTCG|CACCTGCTGCATGCATATAGCAAACCCTGG
GAGTCTTCCGTGTAGAACAACACTCGTAGC|CACTGTTCATCGCTAACGAGCCCATGCCCC
CCGTTGGGCATAGATCTACTGGCTGAGTTT|CTATAGCAAACCTCCGCTAGAAAGGGGCCC
CCCGCACTGTTCGCATGTTTACTAGGGACG|TAGCAAACCCTGGGTGATAGCCCGTCCAGT
GCGACCACGTCGCGTTGATGCCTCTGACCT|TTACATCCAATGATTTCAGGTAACGAACAT
TTACCTCGTTCCCGGCTAGCGTGGTTGGTA|GAGGAAAACAAGTTCGTCCCAACCTGGAGA
ACTGTTCTAGAACCTCCGCTAGAAAGGGGC|AATCCCGGCGCCTGACGTTACGCATCAGGC
GTGTAGAACAACACTCGTAGCGTTCGTCAG|TCGCTAACGAGCCCATGCCCCCTATTTCTA
TGACCTCCGCTACCTCCGCTAGAAAGGGGC|ATGCGACCACGTCGCGTTGATGCCTCTGAC
AGTTTAAATGCATTCACGTGGTTTAAATCC|AAGGGGCCCGCACTGTTCGCGCTGCACCTC
CCCATGTGCTTAACGATAGCTGCCGGAGAA|AAAGGGGCCCGCACTGTTCCTCCGCTAGAA
AGAAAGGGGCCCGCACTGTTCCTCCGCTAG|CTACTGGCTGAGTTTCCTGGCGACGAGTCC
ATGTGCTTAACGATAGCTGCCGGAGAAGTT|GGGGCCCGCACTGTTCCTCCGCTAGAAAGG
TCCGCTAGAAAGGGGCCCGCACTGTTCGCG|ACGAGTCCTTGTCCTTATTAGCTGATCACG
TAGCTTGTAGCTCCTAGCTTCCCACCAGGC|GATTAGGCTGACCTCCGCTACCTCCGCTAG
CACGTATCTGGTGTTCCGCGTAGCCTCTTC|TTACCTCGTTCCCGGCTAGCGTGGTTGGTA
TCCACAAAGATCCTTCCAGTCCGGGGAAAA|TGTTCTTCGCTCCGCAGGTCAACTTCATAT
TCAAGGGGCCCGCACTGTTCAGTTAATCTC|TCGACGGACTACATTAAGATTGCCACACCT
CACCTCCGCTAGAAAGGGGCCCGCACTGTT|GTTTAAATGCATTCACGTGGTTTAAATCCC
ATTCACGTGGTTTAAATCCCGGCGCCTGAC|ACTGTTCGCGCTGCACCTCCGCTAGAAAGG
GTTTAAATCCCGGCGCCTGACGTTACGCAT|GCTGCACCTCCGCTAGAAAGGGGCCCGCAC
CCTCCGCTAGAAAGGGGCCCGCACTGTTCC|GCATAGATCTACTGGCTGAGTTTCCTGGCG
CACTGTTCGCGCTGCACCTCCGCTAGAAAG|AGCTGATCACGTGACCCACCTGCTGCATGC
TAGCTCCTAGCTTCCCACCAGGCGCCGAAA|CTGACCTCCGCTACCTCCGCTAGAAAGGGG
GAACGTTCGACGGACTACATTAAGATTGCC|TGTTTACTAGGGACGTGGGGCTTTCCCCGT
GCGCCGAAAGTATTTCGTTATACGTATGCG|AGAAAGGGGCCCGCACTGTTCAGAAAGGGG
AGTGAGTCTTCCGTGTAGAACAACACTCGT|GTTCACTGTTCATCGCTAACGAGCCCATGC
AACAACACTCGTAGCGTTCGTCAGGTGGAG|ACGAGCCCATGCCCCCTATTTCTACCGTAC
AGATCTACTGGCTGAGTTTCCTGGCGACGA|CTCCGCTAGAAAGGGGCCCGCACTGTTCTA
GACGAGTCCTTGTCCTTATTAGCTGATCAC|TTCTAGGATAAGGAATTCCACAAAGATCCT
TTTACTAGGGACGTGGGGCTTTCCCCGTTG|TAGCCCGTCCAGTCGTAACGGTCACTATAG
TCGTTATACGTATGCGGATGGCGAAGCGCG|ACTGTTCAGAAAGGGGCCCGCACTGTTCGG
GCATTCACGTGGTTTAAATCCCGGCGCCTG|GCACTGTTCGCGCTGCACCTCCGCTAGAAA
GAGTATGCCGTTTCTGTAGAGATGCCGAGG|AACTTACGTAGTGAGTCTTCCGTGTAGAAC
ACACCTCCGCTAGAAAGGGGCCCGCACTGT|TCTCGGGGTAGCCCATGTGCTTAACGATAG
CAGAAAGGGGCCCGCACTGTTCGGTGCGAA|AAGGGGCCCGCACCTCCGCTAGAAAGGGGC
AACCTGGAGATTAGGCTGACCTCCGCTACC|GTCAGGTGGAGAGCCAATGCGACCACGTCG
CCCTCCGCTAGAAAGGGGCCCGCACTGTTC|GAAAGTATTTCGTTATACGTATGCGGATGG
TCCGCTAGAAAGGGGCCCGCACTGTTCAAG|ACGTTACGCATCAGGCGCGGAACGTTCGAC
CACTGTTCGGTGCGAACTTACGTAGTGAGT|TCCGCTAGAAAGGGGCCCGCACTGTTCACT
CACTGTTCGTCGTGCTACATTCGTCGTACG|GCGGATGGCGAAGCGCGCAACGAGTATGCC
CGCACTGTTCCCACCTCCGCACCTCCGCTA|AACGATAGCTGCCGGAGAAGTTTAAATGCA
TACAACACCTCCGCTAGAAAGGGGCCCGCA|TTAATCTCGGGGTAGCCCATGTGCTTAACG
TCTCCCGTGAGGATGGACACAAAACGAGAT|GCCCCGGCTCGGGGGCGCTGTGGGAATGAT
GAAAGGGGCCCGCACTGTTCGCATGTTTAC|CATGCATATAGCAAACCCTGGGTGATAGCC
GTTCAAGGGGCCCGCACTGTTCAGTTAATC|GTTCGACGGACTACATTAAGATTGCCACAC
GATGCCGAGGAAAACAAGTTCGTCCCAACC|CGTGTAGAACAACACTCGTAGCGTTCGTCA
TTCCACAAAGATCCTTCCAGTCCGGGGAAA|CTGTTCTTCGCTCCGCAGGTCAACTTCATA
GTATCTGGTGTTCCGCGTAGCCTCTTCGAA|CCTCGTTCCCGGCTAGCGTGGTTGGTAGCT
GAAAGGGGCCCGCACTGTTCCCTCCGCTAG|TAGCTTCCCACCAGGCGCCGAAAGTATTTC
GTTAATCTCGGGGTAGCCCATGTGCTTAAC|GCCACACCTCCGCTAGAAAGGGGCCCGCAC
GTCTTCCGTGTAGAACAACACTCGTAGCGT|CTGTTCATCGCTAACGAGCCCATGCCCCCT
CCGGAGAAGTTTAAATGCATTCACGTGGTT|CGCTAGAAAGGGGCCCGCACTGTTCGCGCT
GCTTACCTCGTTCCCGGCTAGCGTGGTTGG|CCGAGGAAAACAAGTTCGTCCCAACCTGGA
GAGAAGTTTAAATGCATTCACGTGGTTTAA|TAGAAAGGGGCCCGCACTGTTCGCGCTGCA
GTGCGAACTTACGTAGTGAGTCTTCCGTGT|AAGGGGCCCGCACTGTTCACTGTTCATCGC
TTAAATGCATTCACGTGGTTTAAATCCCGG|GGGCCCGCACTGTTCGCGCTGCACCTCCGC
CTTAACGATAGCTGCCGGAGAAGTTTAAAT|CCGCACTGTTCCTCCGCTAGAAAGGGGCCC
GCGTGGTTGGTAGCTTGTAGCTCCTAGCTT|CCAACCTGGAGATTAGGCTGACCTCCGCTA
TAGGATAAGGAATTCCACAAAGATCCTTCC|AAGGGGCCCGCACTGTTCTTCGCTCCGCAG
TAGATCTACTGGCTGAGTTTCCTGGCGACG|CCTCCGCTAGAAAGGGGCCCGCACTGTTCT
CTTCCAGTCCGGGGAAAATGTCGACAGTAC|CGCAGGTCAACTTCATATTTCGCTGGGGTC
TCCTAGCTTCCCACCAGGCGCCGAAAGTAT|CCTCCGCTACCTCCGCTAGAAAGGGGCCCG
TGGCGACGAGTCCTTGTCCTTATTAGCTGA|ACTGTTCTAGGATAAGGAATTCCACAAAGA
ACGGACTACATTAAGATTGCCACACCTCCG|GGGACGTGGGGCTTTCCCCGTTGGGCATAG
GCACTGTTCAGTTAATCTCGGGGTAGCCCA|CATTAAGATTGCCACACCTCCGCTAGAAAG
GAAAGGGGCCCGCACTGTTCAAGGGGCCCG|GCATCAGGCGCGGAACGTTCGACGGACTAC
ACAAGTTCGTCCCAACCTGGAGATTAGGCT|ACTCGTAGCGTTCGTCAGGTGGAGAGCCAA
CCGCACTGTTCGCATGTTTACTAGGGACGT|AGCAAACCCTGGGTGATAGCCCGTCCAGTC
GCACCTCCGCTAGAAAGGGGCCCGCACTGT|ACCCACCTGCTGCATGCATATAGCAAACCC
CGAGCCCATGCCCCCTATTTCTACCGTACG|GGCCCGCACTGTTCTAGAACCTCCGCTAGA
GCACTGTTCCCACCTCCGCACCTCCGCTAG|ACGATAGCTGCCGGAGAAGTTTAAATGCAT
AGTTAATCTCGGGGTAGCCCATGTGCTTAA|TGCCACACCTCCGCTAGAAAGGGGCCCGCA
GCAACGAGTATGCCGTTTCTGTAGAGATGC|GTGCGAACTTACGTAGTGAGTCTTCCGTGT
CCTCTGACCTCCGCTAGAAAGGGGCCCGCA|TAACGAACATGCTACAACACCTCCGCTAGA
GCACTGTTCGTCGTGCTACATTCGTCGTAC|TGCGGATGGCGAAGCGCGCAACGAGTATGC
ACAACACTCGTAGCGTTCGTCAGGTGGAGA|CGAGCCCATGCCCCCTATTTCTACCGTACG
CACGTGACCCACCTGCTGCATGCATATAGC|CCTTCCAGTCCGGGGAAAATGTCGACAGTA
AGAAAGGGGCCCGCACTGTTCGTCGTGCTA|TCGTTATACGTATGCGGATGGCGAAGCGCG
AAGGGGCCCGCACTGTTCTAGGATAAGGAA|CCTCGGACCTCCGCTAGAAAGGGGCCCGCA
TGTTCAGAAAGGGGCCCGCACTGTTCGGTG|TAGAAAGGGGCCCGCACCTCCGCTAGAAAG
ACGCTTACATCCAATGATTTCAGGTAACGA|GGGGCCCGCACTGTTCAAGGGGCCCGCACT
CCTGGCGACGAGTCCTTGTCCTTATTAGCT|GCACTGTTCTAGGATAAGGAATTCCACAAA
TTACGGGCCTCGTGTAATACAAGTTGAGGG|TACATTCGTCGTACGCATACTGCTCGTCGG
AACTTACGTAGTGAGTCTTCCGTGTAGAAC|GCCCGCACTGTTCACTGTTCATCGCTAACG
CTCCGCTAGAAAGGGGCCCGCACTGTTCAA|GACGTTACGCATCAGGCGCGGAACGTTCGA
GCCCCATCTCCCGTGAGGATGGACACAAAA|GTTCAGGCCCCGGCTCGGGGGCGCTGTGGG
ATTTCGTTATACGTATGCGGATGGCGAAGC|CGCACTGTTCAGAAAGGGGCCCGCACTGTT
CTTACATCCAATGATTTCAGGTAACGAACA|GCCCGCACTGTTCAAGGGGCCCGCACTGTT
GCGAAGCGCGCAACGAGTATGCCGTTTCTG|CACTGTTCGGTGCGAACTTACGTAGTGAGT
TTCGGCCCCATCTCCCGTGAGGATGGACAC|ATGTGTTCAGGCCCCGGCTCGGGGGCGCTG
GCTAGAAAGGGGCCCGCACTGTTCTAGGAT|CGGAAGCCTCGGACCTCCGCTAGAAAGGGG
TAGAAAGGGGCCCGCACTGTTCACTGTTCA|CCGCACTGTTCCCACCTCCGCACCTCCGCT
AAGTTTAAATGCATTCACGTGGTTTAAATC|AAAGGGGCCCGCACTGTTCGCGCTGCACCT
CCGTGAGGATGGACACAAAACGAGATTGAC|CGGCTCGGGGGCGCTGTGGGAATGATCATA
TGGGCATAGATCTACTGGCTGAGTTTCCTG|AGCAAACCTCCGCTAGAAAGGGGCCCGCAC
AATGATTTCAGGTAACGAACATGCTACAAC|GTTCAAGGGGCCCGCACTGTTCAGTTAATC
TTCGCGCTGCACCTCCGCTAGAAAGGGGCC|ATCACGTGACCCACCTGCTGCATGCATATA
GATCACGTGACCCACCTGCTGCATGCATAT|GATCCTTCCAGTCCGGGGAAAATGTCGACA
CTGCATGCATATAGCAAACCCTGGGTGATA|AAAATGTCGACAGTACAACCGACTTCGGCC
GGCTTACCTCGTTCCCGGCTAGCGTGGTTG|GCCGAGGAAAACAAGTTCGTCCCAACCTGG
GGGGTAGCCCATGTGCTTAACGATAGCTGC|CCGCTAGAAAGGGGCCCGCACTGTTCCTCC
CCTCCGCTAGAAAGGGGCCCGCACCTCCGC|CATGCTACAACACCTCCGCTAGAAAGGGGC
CCTCCGCTAGAAAGGGGCCCGCACTGTTCC|CGGGGTAGCCCATGTGCTTAACGATAGCTG
ACCAGGCGCCGAAAGTATTTCGTTATACGT|CCGCTAGAAAGGGGCCCGCACTGTTCAGAA
TATACGTATGCGGATGGCGAAGCGCGCAAC|TTCAGAAAGGGGCCCGCACTGTTCGGTGCG
CTCGGGGTAGCCCATGTGCTTAACGATAGC|CCTCCGCTAGAAAGGGGCCCGCACTGTTCC
GCGCTGCACCTCCGCTAGAAAGGGGCCCGC|ACGTGACCCACCTGCTGCATGCATATAGCA
GATTGCCACACCTCCGCTAGAAAGGGGCCC|TCCCCGTTGGGCATAGATCTACTGGCTGAG
TTTCTGTAGAGATGCCGAGGAAAACAAGTT|GTGAGTCTTCCGTGTAGAACAACACTCGTA
GCTAGAAAGGGGCCCGCACTGTTCCCTCCG|CTCCTAGCTTCCCACCAGGCGCCGAAAGTA
TAGCAAACCCTGGGTGATAGCCCGTCCAGT|AGTACAACCGACTTCGGCCCCATCTCCCGT
TGGGTGATAGCCCGTCCAGTCGTAACGGTC|ACTTCGGCCCCATCTCCCGTGAGGATGGAC
GCACTGTTCTAGAACCTCCGCTAGAAAGGG|TAAATCCCGGCGCCTGACGTTACGCATCAG
GCTACATTCGTCGTACGCATACTGCTCGTC|CGCGCAACGAGTATGCCGTTTCTGTAGAGA
AACCGACTTCGGCCCCATCTCCCGTGAGGA|TAAGGCGATGTGTTCAGGCCCCGGCTCGGG
ACGTAGTGAGTCTTCCGTGTAGAACAACAC|CACTGTTCACTGTTCATCGCTAACGAGCCC
CTGCACCTCCGCTAGAAAGGGGCCCGCACT|TGACCCACCTGCTGCATGCATATAGCAAAC
GGGCCCGCACTGTTCGCATGTTTACTAGGG|ATATAGCAAACCCTGGGTGATAGCCCGTCC
CAGGCGCGGAACGTTCGACGGACTACATTA|TGTTCGCATGTTTACTAGGGACGTGGGGCT
ACATTCGTCGTACGCATACTGCTCGTCGGG|GCAACGAGTATGCCGTTTCTGTAGAGATGC
ACCTCCGCTAGAAAGGGGCCCGCACTGTTC|AAAGGGGCCCGCACTGTTCCCACCTCCGCA
TACAAGTTGAGGGTACACGTATCTGGTGTT|TACTGCTCGTCGGGCTTACCTCGTTCCCGG
CTAGCTTCCCACCAGGCGCCGAAAGTATTT|TCCGCTACCTCCGCTAGAAAGGGGCCCGCA
GCGCCTGACGTTACGCATCAGGCGCGGAAC|CTAGAAAGGGGCCCGCACTGTTCGCATGTT
GGGCCCGCACTGTTCTAGGATAAGGAATTC|CGGACCTCCGCTAGAAAGGGGCCCGCACTG
GGAACGTTCGACGGACTACATTAAGATTGC|ATGTTTACTAGGGACGTGGGGCTTTCCCCG
ACGTTACGCATCAGGCGCGGAACGTTCGAC|GGGGCCCGCACTGTTCGCATGTTTACTAGG
TGCTACAACACCTCCGCTAGAAAGGGGCCC|CAGTTAATCTCGGGGTAGCCCATGTGCTTA
TAGCCTCTTCGAACCTCCGCTAGAAAGGGG|GTGGTTGGTAGCTTGTAGCTCCTAGCTTCC
TAGCTTCCCACCAGGCGCCGAAAGTATTTC|CCGCTACCTCCGCTAGAAAGGGGCCCGCAC
CGCTAGAAAGGGGCCCGCACTGTTCAGAAA|TTGATGCCTCTGACCTCCGCTAGAAAGGGG
CCGCACCTCCGCTAGAAAGGGGCCCGCACT|CTAGAAAGGGGCCCGCACTGTTCCCACCTC
CATTCACGTGGTTTAAATCCCGGCGCCTGA|CACTGTTCGCGCTGCACCTCCGCTAGAAAG
TCACTGTTCATCGCTAACGAGCCCATGCCC|CACCTCCGCTAGAAAGGGGCCCGCACTGTT
CGGCTAGCGTGGTTGGTAGCTTGTAGCTCC|TTCGTCCCAACCTGGAGATTAGGCTGACCT
GTAGCCTCTTCGAACCTCCGCTAGAAAGGG|CGTGGTTGGTAGCTTGTAGCTCCTAGCTTC
TTAAATCCCGGCGCCTGACGTTACGCATCA|TGCACCTCCGCTAGAAAGGGGCCCGCACTG
TGGCGAAGCGCGCAACGAGTATGCCGTTTC|CGCACTGTTCGGTGCGAACTTACGTAGTGA
CCCACCAGGCGCCGAAAGTATTTCGTTATA|CCTCCGCTAGAAAGGGGCCCGCACTGTTCA
CCGCTAGAAAGGGGCCCGCACTGTTCTAGA|AATGCATTCACGTGGTTTAAATCCCGGCGC
AACGTTCGACGGACTACATTAAGATTGCCA|GTTTACTAGGGACGTGGGGCTTTCCCCGTT
GATCCTTCCAGTCCGGGGAAAATGTCGACA|GCTCCGCAGGTCAACTTCATATTTCGCTGG
GGAGAGCCAATGCGACCACGTCGCGTTGAT|GTACGGTACGCTTACATCCAATGATTTCAG
CCCCCTATTTCTACCGTACGGTACGCTTAC|GTTCTAGAACCTCCGCTAGAAAGGGGCCCG
GGGCCCGCACTGTTCGGTGCGAACTTACGT|CCGCACCTCCGCTAGAAAGGGGCCCGCACT
AGGGGCCCGCACTGTTCAGAAAGGGGCCCG|TCTGACCTCCGCTAGAAAGGGGCCCGCACC
CTGTTCTAGGATAAGGAATTCCACAAAGAT|GCTAGAAAGGGGCCCGCACTGTTCTTCGCT
CCGTACGGTACGCTTACATCCAATGATTTC|CGCTAGAAAGGGGCCCGCACTGTTCAAGGG
CGTAGTGAGTCTTCCGTGTAGAACAACACT|ACTGTTCACTGTTCATCGCTAACGAGCCCA
TACGCATCAGGCGCGGAACGTTCGACGGAC|CCCGCACTGTTCGCATGTTTACTAGGGACG
AGGGGCCCGCACTGTTCCCACCTCCGCACC|TGTGCTTAACGATAGCTGCCGGAGAAGTTT
CTTACGGGCCTCGTGTAATACAAGTTGAGG|CTACATTCGTCGTACGCATACTGCTCGTCG
TCCTTCCAGTCCGGGGAAAATGTCGACAGT|TCCGCAGGTCAACTTCATATTTCGCTGGGG
GGCATAGATCTACTGGCTGAGTTTCCTGGC|CAAACCTCCGCTAGAAAGGGGCCCGCACTG
TGCGGATGGCGAAGCGCGCAACGAGTATGC|GGGGCCCGCACTGTTCGGTGCGAACTTACG
TTAATCTCGGGGTAGCCCATGTGCTTAACG|CCACACCTCCGCTAGAAAGGGGCCCGCACT
CCTGACGTTACGCATCAGGCGCGGAACGTT|GAAAGGGGCCCGCACTGTTCGCATGTTTAC
CGAAAGTATTTCGTTATACGTATGCGGATG|AGGGGCCCGCACTGTTCAGAAAGGGGCCCG
CTAGAAAGGGGCCCGCACTGTTCCTCCGCT|ATCTACTGGCTGAGTTTCCTGGCGACGAGT
CCAGTCGTAACGGTCACTATAGCAAACCTC|CCCGTGAGGATGGACACAAAACGAGATTGA
CCTCCGCTAGAAAGGGGCCCGCACTGTTCG|AAAGTATTTCGTTATACGTATGCGGATGGC
TCGGGCTTACCTCGTTCCCGGCTAGCGTGG|GATGCCGAGGAAAACAAGTTCGTCCCAACC
GAAAGGGGCCCGCACTGTTCTAGAACCTCC|TTCACGTGGTTTAAATCCCGGCGCCTGACG
CGCACCTCCGCTAGAAAGGGGCCCGCACTG|AAGTTTAAATGCATTCACGTGGTTTAAATC
GGGGCTTTCCCCGTTGGGCATAGATCTACT|GTAACGGTCACTATAGCAAACCTCCGCTAG
AAGGGGCCCGCACTGTTCAGAAAGGGGCCC|CTCTGACCTCCGCTAGAAAGGGGCCCGCAC
GTACACGTATCTGGTGTTCCGCGTAGCCTC|GGCTTACCTCGTTCCCGGCTAGCGTGGTTG
TCGGGGTAGCCCATGTGCTTAACGATAGCT|CTCCGCTAGAAAGGGGCCCGCACTGTTCCT
CACTGTTCACTGTTCATCGCTAACGAGCCC|CCTCCGCACCTCCGCTAGAAAGGGGCCCGC
ACTGTTCTAGGATAAGGAATTCCACAAAGA|CGCTAGAAAGGGGCCCGCACTGTTCTTCGC
GATCTACTGGCTGAGTTTCCTGGCGACGAG|TCCGCTAGAAAGGGGCCCGCACTGTTCTAG
TTACATCCAATGATTTCAGGTAACGAACAT|CCCGCACTGTTCAAGGGGCCCGCACTGTTC
AAAGGGGCCCGCACTGTTCCCACCTCCGCA|CATGTGCTTAACGATAGCTGCCGGAGAAGT
CCCGTTGGGCATAGATCTACTGGCTGAGTT|ACTATAGCAAACCTCCGCTAGAAAGGGGCC
ACTAGGGACGTGGGGCTTTCCCCGTTGGGC|CCCGTCCAGTCGTAACGGTCACTATAGCAA
GGGGCCCGCACCTCCGCTAGAAAGGGGCCC|CTCCGCTAGAAAGGGGCCCGCACTGTTCCC
GTTCGTCAGGTGGAGAGCCAATGCGACCAC|CTATTTCTACCGTACGGTACGCTTACATCC
AGAAAGGGGCCCGCACCTCCGCTAGAAAGG|AACACCTCCGCTAGAAAGGGGCCCGCACTG
TGTAATACAAGTTGAGGGTACACGTATCTG|ACGCATACTGCTCGTCGGGCTTACCTCGTT
TCTGGTGTTCCGCGTAGCCTCTTCGAACCT|CGTTCCCGGCTAGCGTGGTTGGTAGCTTGT
AACCTCCGCTAGAAAGGGGCCCGCACTGTT|CCTGACGTTACGCATCAGGCGCGGAACGTT
GACCTCCGCTACCTCCGCTAGAAAGGGGCC|TGCGACCACGTCGCGTTGATGCCTCTGACC
GCCCGCACTGTTCACTGTTCATCGCTAACG|TCCCACCTCCGCACCTCCGCTAGAAAGGGG
CTGTTCCCACCTCCGCACCTCCGCTAGAAA|ATAGCTGCCGGAGAAGTTTAAATGCATTCA
CCTGGGTGATAGCCCGTCCAGTCGTAACGG|CGACTTCGGCCCCATCTCCCGTGAGGATGG
AGATTGCCACACCTCCGCTAGAAAGGGGCC|TTCCCCGTTGGGCATAGATCTACTGGCTGA
AGTTGAGGGTACACGTATCTGGTGTTCCGC|GCTCGTCGGGCTTACCTCGTTCCCGGCTAG
TCGCTAACGAGCCCATGCCCCCTATTTCTA|AGAAAGGGGCCCGCACTGTTCTAGAACCTC
GGCCTCGTGTAATACAAGTTGAGGGTACAC|TCGTCGTACGCATACTGCTCGTCGGGCTTA
CTCGTTCCCGGCTAGCGTGGTTGGTAGCTT|AAAACAAGTTCGTCCCAACCTGGAGATTAG
GTTCGCATGTTTACTAGGGACGTGGGGCTT|CCTGGGTGATAGCCCGTCCAGTCGTAACGG
TTCAGAAAGGGGCCCGCACTGTTCGGTGCG|GAAAGGGGCCCGCACCTCCGCTAGAAAGGG
AAGGGGCCCGCACTGTTCTAGAACCTCCGC|CACGTGGTTTAAATCCCGGCGCCTGACGTT
CCCCATCTCCCGTGAGGATGGACACAAAAC|TTCAGGCCCCGGCTCGGGGGCGCTGTGGGA
GGGGAAAATGTCGACAGTACAACCGACTTC|CTTCATATTTCGCTGGGGTCTAAGGCGATG
TGTTTACTAGGGACGTGGGGCTTTCCCCGT|GATAGCCCGTCCAGTCGTAACGGTCACTAT
CCGCTAGAAAGGGGCCCGCACTGTTCCCTC|AGCTCCTAGCTTCCCACCAGGCGCCGAAAG
AGCAAACCTCCGCTAGAAAGGGGCCCGCAC|ACGAGATTGACCGGAAGCCTCGGACCTCCG
CTCCCGTGAGGATGGACACAAAACGAGATT|CCCCGGCTCGGGGGCGCTGTGGGAATGATC
TAACGAGCCCATGCCCCCTATTTCTACCGT|AGGGGCCCGCACTGTTCTAGAACCTCCGCT
GGTTGGTAGCTTGTAGCTCCTAGCTTCCCA|CCTGGAGATTAGGCTGACCTCCGCTACCTC
AAACCTCCGCTAGAAAGGGGCCCGCACTGT|AGATTGACCGGAAGCCTCGGACCTCCGCTA
CATGTGCTTAACGATAGCTGCCGGAGAAGT|AGGGGCCCGCACTGTTCCTCCGCTAGAAAG
ACACGTATCTGGTGTTCCGCGTAGCCTCTT|CTTACCTCGTTCCCGGCTAGCGTGGTTGGT
TGGAGATTAGGCTGACCTCCGCTACCTCCG|GGTGGAGAGCCAATGCGACCACGTCGCGTT
CCCACCTCCGCACCTCCGCTAGAAAGGGGC|TGCCGGAGAAGTTTAAATGCATTCACGTGG
ACGTATGCGGATGGCGAAGCGCGCAACGAG|AGAAAGGGGCCCGCACTGTTCGGTGCGAAC
CCCACCTGCTGCATGCATATAGCAAACCCT|GTCCGGGGAAAATGTCGACAGTACAACCGA
CGTGGGGCTTTCCCCGTTGGGCATAGATCT|GTCGTAACGGTCACTATAGCAAACCTCCGC
CTGCCGGAGAAGTTTAAATGCATTCACGTG|CTCCGCTAGAAAGGGGCCCGCACTGTTCGC
TAGGCTGACCTCCGCTACCTCCGCTAGAAA|AGCCAATGCGACCACGTCGCGTTGATGCCT
TGGTGTTCCGCGTAGCCTCTTCGAACCTCC|TTCCCGGCTAGCGTGGTTGGTAGCTTGTAG
TATAACTTACGGGCCTCGTGTAATACAAGT|TCGTGCTACATTCGTCGTACGCATACTGCT
GCCCCCTATTTCTACCGTACGGTACGCTTA|TGTTCTAGAACCTCCGCTAGAAAGGGGCCC
CAGTCGTAACGGTCACTATAGCAAACCTCC|CCGTGAGGATGGACACAAAACGAGATTGAC
GGGTACACGTATCTGGTGTTCCGCGTAGCC|CGGGCTTACCTCGTTCCCGGCTAGCGTGGT
AGTATTTCGTTATACGTATGCGGATGGCGA|GCCCGCACTGTTCAGAAAGGGGCCCGCACT
AACGGTCACTATAGCAAACCTCCGCTAGAA|GATGGACACAAAACGAGATTGACCGGAAGC
TAGTGAGTCTTCCGTGTAGAACAACACTCG|TGTTCACTGTTCATCGCTAACGAGCCCATG
TATCTGGTGTTCCGCGTAGCCTCTTCGAAC|CTCGTTCCCGGCTAGCGTGGTTGGTAGCTT
TCCTTGTCCTTATTAGCTGATCACGTGACC|GATAAGGAATTCCACAAAGATCCTTCCAGT
CGCACTGTTCACTGTTCATCGCTAACGAGC|CACCTCCGCACCTCCGCTAGAAAGGGGCCC
ATCTCGGGGTAGCCCATGTGCTTAACGATA|CACCTCCGCTAGAAAGGGGCCCGCACTGTT
GGCGACGAGTCCTTGTCCTTATTAGCTGAT|CTGTTCTAGGATAAGGAATTCCACAAAGAT
CCCGCACTGTTCGCGCTGCACCTCCGCTAG|TATTAGCTGATCACGTGACCCACCTGCTGC
GAAAACAAGTTCGTCCCAACCTGGAGATTA|CAACACTCGTAGCGTTCGTCAGGTGGAGAG
TGGTTGGTAGCTTGTAGCTCCTAGCTTCCC|ACCTGGAGATTAGGCTGACCTCCGCTACCT
GACGTGGGGCTTTCCCCGTTGGGCATAGAT|CAGTCGTAACGGTCACTATAGCAAACCTCC
TTTCGTTATACGTATGCGGATGGCGAAGCG|GCACTGTTCAGAAAGGGGCCCGCACTGTTC
AGAAAGGGGCCCGCACTGTTCACTGTTCAT|CGCACTGTTCCCACCTCCGCACCTCCGCTA
AGGGGCCCGCACTGTTCGTCGTGCTACATT|TATACGTATGCGGATGGCGAAGCGCGCAAC
CACTGTTCTAGAACCTCCGCTAGAAAGGGG|AAATCCCGGCGCCTGACGTTACGCATCAGG
GAGAGCCAATGCGACCACGTCGCGTTGATG|TACGGTACGCTTACATCCAATGATTTCAGG
AGCAAACCCTGGGTGATAGCCCGTCCAGTC|GTACAACCGACTTCGGCCCCATCTCCCGTG
TGTTCGCATGTTTACTAGGGACGTGGGGCT|CCCTGGGTGATAGCCCGTCCAGTCGTAACG
GGGCCCGCACTGTTCAAGGGGCCCGCACTG|AGGCGCGGAACGTTCGACGGACTACATTAA
GTTCGACGGACTACATTAAGATTGCCACAC|TACTAGGGACGTGGGGCTTTCCCCGTTGGG
TCCAGTCGTAACGGTCACTATAGCAAACCT|TCCCGTGAGGATGGACACAAAACGAGATTG
CGTCAGGTGGAGAGCCAATGCGACCACGTC|TTTCTACCGTACGGTACGCTTACATCCAAT
TGTCCTTATTAGCTGATCACGTGACCCACC|AGGAATTCCACAAAGATCCTTCCAGTCCGG
CCTAGCTTCCCACCAGGCGCCGAAAGTATT|CTCCGCTACCTCCGCTAGAAAGGGGCCCGC
TCCGCTAGAAAGGGGCCCGCACTGTTCGCA|CCTGCTGCATGCATATAGCAAACCCTGGGT
GTTCCCACCTCCGCACCTCCGCTAGAAAGG|AGCTGCCGGAGAAGTTTAAATGCATTCACG
CGTCGTACGCATACTGCTCGTCGGGCTTAC|GAGTATGCCGTTTCTGTAGAGATGCCGAGG
CTGGCGACGAGTCCTTGTCCTTATTAGCTG|CACTGTTCTAGGATAAGGAATTCCACAAAG
AGCCCATGTGCTTAACGATAGCTGCCGGAG|AGAAAGGGGCCCGCACTGTTCCTCCGCTAG
CCCTATTTCTACCGTACGGTACGCTTACAT|TCTAGAACCTCCGCTAGAAAGGGGCCCGCA
GCCCGCACCTCCGCTAGAAAGGGGCCCGCA|CGCTAGAAAGGGGCCCGCACTGTTCCCACC
CGCTAGAAAGGGGCCCGCACTGTTCACTGT|GGCCCGCACTGTTCCCACCTCCGCACCTCC
GCACCTCCGCTAGAAAGGGGCCCGCACTGT|AGTTTAAATGCATTCACGTGGTTTAAATCC
AAGGGGCCCGCACTGTTCGGTGCGAACTTA|GGCCCGCACCTCCGCTAGAAAGGGGCCCGC
CCACACCTCCGCTAGAAAGGGGCCCGCACT|GTTGGGCATAGATCTACTGGCTGAGTTTCC
AGCGCGCAACGAGTATGCCGTTTCTGTAGA|GTTCGGTGCGAACTTACGTAGTGAGTCTTC
TAGTTAGATAGTTGCCTGGTATAACTTACG|AAGGGGCCCGCACTGTTCGTCGTGCTACAT
CGAAGCGCGCAACGAGTATGCCGTTTCTGT|ACTGTTCGGTGCGAACTTACGTAGTGAGTC
ATCCTTCCAGTCCGGGGAAAATGTCGACAG|CTCCGCAGGTCAACTTCATATTTCGCTGGG
TCTTCCGTGTAGAACAACACTCGTAGCGTT|TGTTCATCGCTAACGAGCCCATGCCCCCTA
ACAAAGATCCTTCCAGTCCGGGGAAAATGT|TCTTCGCTCCGCAGGTCAACTTCATATTTC
TACGGTACGCTTACATCCAATGATTTCAGG|TAGAAAGGGGCCCGCACTGTTCAAGGGGCC
GCTAGAAAGGGGCCCGCACTGTTCGCGCTG|AGTCCTTGTCCTTATTAGCTGATCACGTGA
TGTTCACTGTTCATCGCTAACGAGCCCATG|CCGCACCTCCGCTAGAAAGGGGCCCGCACT
CAGTACAACCGACTTCGGCCCCATCTCCCG|GGGGTCTAAGGCGATGTGTTCAGGCCCCGG
CCGTCCAGTCGTAACGGTCACTATAGCAAA|ATCTCCCGTGAGGATGGACACAAAACGAGA
GTGGTTGGTAGCTTGTAGCTCCTAGCTTCC|AACCTGGAGATTAGGCTGACCTCCGCTACC
TCGTCCCAACCTGGAGATTAGGCTGACCTC|AGCGTTCGTCAGGTGGAGAGCCAATGCGAC
TAGAAAGGGGCCCGCACTGTTCCCACCTCC|GCCCATGTGCTTAACGATAGCTGCCGGAGA
TGCTCGTCGGGCTTACCTCGTTCCCGGCTA|TGTAGAGATGCCGAGGAAAACAAGTTCGTC
CGCTAGAAAGGGGCCCGCACTGTTCCCACC|GTAGCCCATGTGCTTAACGATAGCTGCCGG
GGTGATAGCCCGTCCAGTCGTAACGGTCAC|TTCGGCCCCATCTCCCGTGAGGATGGACAC
GGCCCGCACTGTTCGCATGTTTACTAGGGA|TATAGCAAACCCTGGGTGATAGCCCGTCCA
CTCCGCTAGAAAGGGGCCCGCACTGTTCCC|GTAGCTCCTAGCTTCCCACCAGGCGCCGAA
ACTTACGTAGTGAGTCTTCCGTGTAGAACA|CCCGCACTGTTCACTGTTCATCGCTAACGA
CTCCTAGCTTCCCACCAGGCGCCGAAAGTA|ACCTCCGCTACCTCCGCTAGAAAGGGGCCC
CTCTGACCTCCGCTAGAAAGGGGCCCGCAC|AACGAACATGCTACAACACCTCCGCTAGAA
TCCGCTAGAAAGGGGCCCGCACTGTTCTAG|AAATGCATTCACGTGGTTTAAATCCCGGCG
TGCTGCATGCATATAGCAAACCCTGGGTGA|GGAAAATGTCGACAGTACAACCGACTTCGG
AGCTGATCACGTGACCCACCTGCTGCATGC|CAAAGATCCTTCCAGTCCGGGGAAAATGTC
TTGCCACACCTCCGCTAGAAAGGGGCCCGC|CCCGTTGGGCATAGATCTACTGGCTGAGTT
CCGCACTGTTCGTCGTGCTACATTCGTCGT|TATGCGGATGGCGAAGCGCGCAACGAGTAT
TACTAGGGACGTGGGGCTTTCCCCGTTGGG|GCCCGTCCAGTCGTAACGGTCACTATAGCA
GGCCCGCACTGTTCAGTTAATCTCGGGGTA|GACTACATTAAGATTGCCACACCTCCGCTA
TGTTCAAGGGGCCCGCACTGTTCAGTTAAT|CGTTCGACGGACTACATTAAGATTGCCACA
ACGAGTATGCCGTTTCTGTAGAGATGCCGA|CGAACTTACGTAGTGAGTCTTCCGTGTAGA
AATACAAGTTGAGGGTACACGTATCTGGTG|CATACTGCTCGTCGGGCTTACCTCGTTCCC
TAGAAAGGGGCCCGCACTGTTCAAGGGGCC|ACGCATCAGGCGCGGAACGTTCGACGGACT
CCTCCGCTAGAAAGGGGCCCGCACTGTTCA|TGACGTTACGCATCAGGCGCGGAACGTTCG
AGTCTTCCGTGTAGAACAACACTCGTAGCG|ACTGTTCATCGCTAACGAGCCCATGCCCCC
ACGTATCTGGTGTTCCGCGTAGCCTCTTCG|TACCTCGTTCCCGGCTAGCGTGGTTGGTAG
CAGTTAATCTCGGGGTAGCCCATGTGCTTA|TTGCCACACCTCCGCTAGAAAGGGGCCCGC
GGCCCGCACTGTTCAGAAAGGGGCCCGCAC|GACCTCCGCTAGAAAGGGGCCCGCACCTCC
TATGCCGTTTCTGTAGAGATGCCGAGGAAA|TTACGTAGTGAGTCTTCCGTGTAGAACAAC
GCCGAGGAAAACAAGTTCGTCCCAACCTGG|GTAGAACAACACTCGTAGCGTTCGTCAGGT
GTATTTCGTTATACGTATGCGGATGGCGAA|CCCGCACTGTTCAGAAAGGGGCCCGCACTG
TCGTCGTGCTACATTCGTCGTACGCATACT|GGCGAAGCGCGCAACGAGTATGCCGTTTCT
GTGAGGATGGACACAAAACGAGATTGACCG|GCTCGGGGGCGCTGTGGGAATGATCATAGT
CCTCCGCTACCTCCGCTAGAAAGGGGCCCG|CGACCACGTCGCGTTGATGCCTCTGACCTC
CGCTAGAAAGGGGCCCGCACTGTTCCTCCG|AGATCTACTGGCTGAGTTTCCTGGCGACGA
AGCTTGTAGCTCCTAGCTTCCCACCAGGCG|ATTAGGCTGACCTCCGCTACCTCCGCTAGA
ACTGTTCAGTTAATCTCGGGGTAGCCCATG|TTAAGATTGCCACACCTCCGCTAGAAAGGG
CCGCACTGTTCAGAAAGGGGCCCGCACTGT|CTCCGCTAGAAAGGGGCCCGCACCTCCGCT
GCGGAACGTTCGACGGACTACATTAAGATT|GCATGTTTACTAGGGACGTGGGGCTTTCCC
ATCGCTAACGAGCCCATGCCCCCTATTTCT|TAGAAAGGGGCCCGCACTGTTCTAGAACCT
GGTATAACTTACGGGCCTCGTGTAATACAA|CGTCGTGCTACATTCGTCGTACGCATACTG
GTGTAATACAAGTTGAGGGTACACGTATCT|TACGCATACTGCTCGTCGGGCTTACCTCGT
CTGATCACGTGACCCACCTGCTGCATGCAT|AAGATCCTTCCAGTCCGGGGAAAATGTCGA
GCGCGGAACGTTCGACGGACTACATTAAGA|TCGCATGTTTACTAGGGACGTGGGGCTTTC
TAATACAAGTTGAGGGTACACGTATCTGGT|GCATACTGCTCGTCGGGCTTACCTCGTTCC
GCTACAACACCTCCGCTAGAAAGGGGCCCG|AGTTAATCTCGGGGTAGCCCATGTGCTTAA
GGGGCCCGCACTGTTCCCACCTCCGCACCT|GTGCTTAACGATAGCTGCCGGAGAAGTTTA
GTAGTGAGTCTTCCGTGTAGAACAACACTC|CTGTTCACTGTTCATCGCTAACGAGCCCAT
GCGTAGCCTCTTCGAACCTCCGCTAGAAAG|AGCGTGGTTGGTAGCTTGTAGCTCCTAGCT
CAACACCTCCGCTAGAAAGGGGCCCGCACT|AATCTCGGGGTAGCCCATGTGCTTAACGAT
TGTTCTAGAACCTCCGCTAGAAAGGGGCCC|TCCCGGCGCCTGACGTTACGCATCAGGCGC
AGGAATTCCACAAAGATCCTTCCAGTCCGG|CCGCACTGTTCTTCGCTCCGCAGGTCAACT
CGCACTGTTCTAGAACCTCCGCTAGAAAGG|TTAAATCCCGGCGCCTGACGTTACGCATCA
CATTCGTCGTACGCATACTGCTCGTCGGGC|CAACGAGTATGCCGTTTCTGTAGAGATGCC
GTCGCGTTGATGCCTCTGACCTCCGCTAGA|AATGATTTCAGGTAACGAACATGCTACAAC
CTAGAAAGGGGCCCGCACTGTTCCCACCTC|AGCCCATGTGCTTAACGATAGCTGCCGGAG
TGCGAACTTACGTAGTGAGTCTTCCGTGTA|AGGGGCCCGCACTGTTCACTGTTCATCGCT
GTTACGCATCAGGCGCGGAACGTTCGACGG|GGCCCGCACTGTTCGCATGTTTACTAGGGA
CTGTTCGCGCTGCACCTCCGCTAGAAAGGG|CTGATCACGTGACCCACCTGCTGCATGCAT
AAGGGGCCCGCACTGTTCGTCGTGCTACAT|TTATACGTATGCGGATGGCGAAGCGCGCAA
GAAAGGGGCCCGCACTGTTCGGTGCGAACT|GGGGCCCGCACCTCCGCTAGAAAGGGGCCC
ATCTCCCGTGAGGATGGACACAAAACGAGA|GGCCCCGGCTCGGGGGCGCTGTGGGAATGA
GCCCGCACTGTTCGCGCTGCACCTCCGCTA|TTATTAGCTGATCACGTGACCCACCTGCTG
AGTTAGATAGTTGCCTGGTATAACTTACGG|AGGGGCCCGCACTGTTCGTCGTGCTACATT
GCACTGTTCTAGGATAAGGAATTCCACAAA|TCCGCTAGAAAGGGGCCCGCACTGTTCTTC
CGTGTAATACAAGTTGAGGGTACACGTATC|GTACGCATACTGCTCGTCGGGCTTACCTCG
CTGTTCACTGTTCATCGCTAACGAGCCCAT|TCCGCACCTCCGCTAGAAAGGGGCCCGCAC
GTCCGGGGAAAATGTCGACAGTACAACCGA|TCAACTTCATATTTCGCTGGGGTCTAAGGC
CTCCGCTAGAAAGGGGCCCGCACTGTTCGT|AAGTATTTCGTTATACGTATGCGGATGGCG
TACGTAGTGAGTCTTCCGTGTAGAACAACA|GCACTGTTCACTGTTCATCGCTAACGAGCC
GGCCCGCACTGTTCCCTCCGCTAGAAAGGG|CCCACCAGGCGCCGAAAGTATTTCGTTATA
CGGGGAAAATGTCGACAGTACAACCGACTT|ACTTCATATTTCGCTGGGGTCTAAGGCGAT
TCAGGTAACGAACATGCTACAACACCTCCG|GGGCCCGCACTGTTCAGTTAATCTCGGGGT
ACTGTTCACTGTTCATCGCTAACGAGCCCA|CTCCGCACCTCCGCTAGAAAGGGGCCCGCA
TTATACGTATGCGGATGGCGAAGCGCGCAA|GTTCAGAAAGGGGCCCGCACTGTTCGGTGC
CATCCAATGATTTCAGGTAACGAACATGCT|GCACTGTTCAAGGGGCCCGCACTGTTCAGT
TATAGCAAACCCTGGGTGATAGCCCGTCCA|ACAGTACAACCGACTTCGGCCCCATCTCCC
GCCTCGTGTAATACAAGTTGAGGGTACACG|CGTCGTACGCATACTGCTCGTCGGGCTTAC
TCACGTGACCCACCTGCTGCATGCATATAG|TCCTTCCAGTCCGGGGAAAATGTCGACAGT
AAGATCCTTCCAGTCCGGGGAAAATGTCGA|TCGCTCCGCAGGTCAACTTCATATTTCGCT
TCCTCCGCTAGAAAGGGGCCCGCACTGTTC|GCGACGAGTCCTTGTCCTTATTAGCTGATC
GAAAATGTCGACAGTACAACCGACTTCGGC|CATATTTCGCTGGGGTCTAAGGCGATGTGT
TCTAGGATAAGGAATTCCACAAAGATCCTT|GAAAGGGGCCCGCACTGTTCTTCGCTCCGC
GTTCACTGTTCATCGCTAACGAGCCCATGC|CGCACCTCCGCTAGAAAGGGGCCCGCACTG
ACCTCCGCTAGAAAGGGGCCCGCACTGTTC|TCGGGGTAGCCCATGTGCTTAACGATAGCT
CCCGCACTGTTCAGTTAATCTCGGGGTAGC|CTACATTAAGATTGCCACACCTCCGCTAGA
GAAAGGGGCCCGCACCTCCGCTAGAAAGGG|ACACCTCCGCTAGAAAGGGGCCCGCACTGT
CTGTTCATCGCTAACGAGCCCATGCCCCCT|CTCCGCTAGAAAGGGGCCCGCACTGTTCTA
AGAAAGGGGCCCGCACTGTTCGCATGTTTA|GCATGCATATAGCAAACCCTGGGTGATAGC
TGCTTAACGATAGCTGCCGGAGAAGTTTAA|GCCCGCACTGTTCCTCCGCTAGAAAGGGGC
GCGGATGGCGAAGCGCGCAACGAGTATGCC|GGGCCCGCACTGTTCGGTGCGAACTTACGT
GCTTTCCCCGTTGGGCATAGATCTACTGGC|ACGGTCACTATAGCAAACCTCCGCTAGAAA
TGCCGGAGAAGTTTAAATGCATTCACGTGG|TCCGCTAGAAAGGGGCCCGCACTGTTCGCG
AAAGGGGCCCGCACTGTTCTAGGATAAGGA|GCCTCGGACCTCCGCTAGAAAGGGGCCCGC
ACCTGGAGATTAGGCTGACCTCCGCTACCT|TCAGGTGGAGAGCCAATGCGACCACGTCGC
AACGAGTATGCCGTTTCTGTAGAGATGCCG|GCGAACTTACGTAGTGAGTCTTCCGTGTAG
CCGCTACCTCCGCTAGAAAGGGGCCCGCAC|CCACGTCGCGTTGATGCCTCTGACCTCCGC
CTACCTCCGCTAGAAAGGGGCCCGCACTGT|CGTCGCGTTGATGCCTCTGACCTCCGCTAG
CCTCGTTCCCGGCTAGCGTGGTTGGTAGCT|GAAAACAAGTTCGTCCCAACCTGGAGATTA
CTGTAGAGATGCCGAGGAAAACAAGTTCGT|AGTCTTCCGTGTAGAACAACACTCGTAGCG
TCGGCCCCATCTCCCGTGAGGATGGACACA|TGTGTTCAGGCCCCGGCTCGGGGGCGCTGT
ACCTGCTGCATGCATATAGCAAACCCTGGG|CGGGGAAAATGTCGACAGTACAACCGACTT
GTCGACAGTACAACCGACTTCGGCCCCATC|TCGCTGGGGTCTAAGGCGATGTGTTCAGGC
CCACAAAGATCCTTCCAGTCCGGGGAAAAT|GTTCTTCGCTCCGCAGGTCAACTTCATATT
CACACCTCCGCTAGAAAGGGGCCCGCACTG|TTGGGCATAGATCTACTGGCTGAGTTTCCT
AGGCTGACCTCCGCTACCTCCGCTAGAAAG|GCCAATGCGACCACGTCGCGTTGATGCCTC
ACGAGTCCTTGTCCTTATTAGCTGATCACG|TCTAGGATAAGGAATTCCACAAAGATCCTT
TACGGGCCTCGTGTAATACAAGTTGAGGGT|ACATTCGTCGTACGCATACTGCTCGTCGGG
AAGCGCGCAACGAGTATGCCGTTTCTGTAG|TGTTCGGTGCGAACTTACGTAGTGAGTCTT
CCTCGTGTAATACAAGTTGAGGGTACACGT|GTCGTACGCATACTGCTCGTCGGGCTTACC
TTATTAGCTGATCACGTGACCCACCTGCTG|TTCCACAAAGATCCTTCCAGTCCGGGGAAA
GGCGCGGAACGTTCGACGGACTACATTAAG|TTCGCATGTTTACTAGGGACGTGGGGCTTT
ATGATTTCAGGTAACGAACATGCTACAACA|TTCAAGGGGCCCGCACTGTTCAGTTAATCT
GCTAGAAAGGGGCCCGCACTGTTCAAGGGG|TTACGCATCAGGCGCGGAACGTTCGACGGA
ATGCGACCACGTCGCGTTGATGCCTCTGAC|GCTTACATCCAATGATTTCAGGTAACGAAC
CGCACTGTTCAGTTAATCTCGGGGTAGCCC|ACATTAAGATTGCCACACCTCCGCTAGAAA
GCACTGTTCGCATGTTTACTAGGGACGTGG|CAAACCCTGGGTGATAGCCCGTCCAGTCGT
CACTGTTCAGAAAGGGGCCCGCACTGTTCG|CGCTAGAAAGGGGCCCGCACCTCCGCTAGA
CAATGCGACCACGTCGCGTTGATGCCTCTG|ACGCTTACATCCAATGATTTCAGGTAACGA
GTACAACCGACTTCGGCCCCATCTCCCGTG|GGTCTAAGGCGATGTGTTCAGGCCCCGGCT
CTCCGCTAGAAAGGGGCCCGCACTGTTCGC|GACGAGTCCTTGTCCTTATTAGCTGATCAC
CTCCGCTAGAAAGGGGCCCGCACTGTTCAC|AGGGGCCCGCACTGTTCCCACCTCCGCACC
CTAGCGTGGTTGGTAGCTTGTAGCTCCTAG|GTCCCAACCTGGAGATTAGGCTGACCTCCG
CCGTGTAGAACAACACTCGTAGCGTTCGTC|CATCGCTAACGAGCCCATGCCCCCTATTTC
GGGTGATAGCCCGTCCAGTCGTAACGGTCA|CTTCGGCCCCATCTCCCGTGAGGATGGACA
CGTCGGGCTTACCTCGTTCCCGGCTAGCGT|GAGATGCCGAGGAAAACAAGTTCGTCCCAA
CTAGGGACGTGGGGCTTTCCCCGTTGGGCA|CCGTCCAGTCGTAACGGTCACTATAGCAAA
ACCGTACGGTACGCTTACATCCAATGATTT|CCGCTAGAAAGGGGCCCGCACTGTTCAAGG
GCTAGAAAGGGGCCCGCACTGTTCACTGTT|GCCCGCACTGTTCCCACCTCCGCACCTCCG
TAACGAACATGCTACAACACCTCCGCTAGA|CGCACTGTTCAGTTAATCTCGGGGTAGCCC
TACGCATACTGCTCGTCGGGCTTACCTCGT|TGCCGTTTCTGTAGAGATGCCGAGGAAAAC
GGTGGAGAGCCAATGCGACCACGTCGCGTT|ACCGTACGGTACGCTTACATCCAATGATTT
GACCTCCGCTAGAAAGGGGCCCGCACCTCC|AACATGCTACAACACCTCCGCTAGAAAGGG
AGGAAAACAAGTTCGTCCCAACCTGGAGAT|AACAACACTCGTAGCGTTCGTCAGGTGGAG
GCACTGTTCACTGTTCATCGCTAACGAGCC|ACCTCCGCACCTCCGCTAGAAAGGGGCCCG
GGACTACATTAAGATTGCCACACCTCCGCT|GACGTGGGGCTTTCCCCGTTGGGCATAGAT
